abandonados	abandonnés
abolicionista	abolitionniste
abolicionistas	abolitionnistes
abolición	l'abolition
abolida	abolie
abolido	aboli
aborigen	aborigène
abril	avril
absoluta	absolue
absorben	absorbent
absorbido	absorbé
absorción	d'absorption
abstención	abstention
abstenerse	s'abstenir
abstracción	abstraction
abstracta	abstraite
abstractas	abstraites
abstracto	abstrait
absurdas	absurdes
absurdo	absurde
absurdos	absurdes
abusiva	abusive
academias	académies
académico	académique
accesible	accessible
accesibles	accessibles
accesorias	accessoires
accidental	accidentelle
accidentalmente	accidentellement
accidente	accident
accidentes	accidents
acciones	actions
aceleraciones	accélérations
acepta	accepte
aceptable	acceptable
aceptables	acceptables
aceptado	accepté
aceptar	accepter
acero	l'acier
acético	acétique
ácidos	acides
aclamado	acclamé
acompañamiento	d'accompagnement
acompañar	accompagner
actitudes	attitudes
activado	activé
activados	activés
activamente	activement
activas	actives
actividades	activités
activo	actif
activos	actifs
actores	acteurs
actos	actes
actualmente	actuellement
acuario	aquarium
acuerdos	accords
acusaciones	accusations
acusados	accusés
adaptaciones	adaptations
adaptar	adapter
aditivo	additif
aditivos	additifs
administraciones	administrations
administrador	administrateur
administradores	administrateurs
administrativa	administrative
administrativamente	administrativement
administrativas	administratives
administrativos	administratives
admiración	admiration
admirado	admiré
admirador	admirateur
adolescencia	l'adolescence
adolescentes	adolescents
adopción	l'adoption
adoración	l'adoration
adquisiciones	acquisitions
aduana	douane
aduanas	douanes
aduanero	douanier
adulta	adulte
adulterio	adultère
adulto	adulte
adultos	adultes
adversario	adversaire
adversarios	adversaires
aéreas	aériennes
aéreo	aérien
aéreos	aériens
aeródromos	aérodromes
aeroespacial	aérospatiale
aeropuertos	aéroports
aerosoles	aérosols
afectiva	affective
afgana	afghane
afgano	afghan
afganos	afghans
Africana	africaine
africanas	africaines
africano	africain
africanos	africains
agencia	agence
agencias	agences
agitado	agité
ágora	agora
ágora	l'agora
agresiva	agressive
agresivas	agressives
agresividad	l'agressivité
agresivo	agressif
agresivos	agressifs
agresores	agresseurs
agrícola	agricole
agrícolas	agricoles
agricultores	agriculteurs
agricultura	l'agriculture
Agricultura	l'agriculture
agroalimentaria	agroalimentaire
agroalimentaria	agro-alimentaire
agroalimentarias	agroalimentaires
agroalimentario	agroalimentaire
aislar	isoler
ajustes	ajustements
albanesa	albanaise
albanés	albanais
álbumes	albums
alcoholes	alcools
alcoholismo	l'alcoolisme
aleatoria	aléatoire
aleatorias	aléatoires
aleatorio	aléatoire
alemana	allemande
alemán	allemand
alemanas	allemandes
alemanes	allemands
alergias	allergies
alerta	d'alerte
alertaron	alerté
alfabeto	alphabet
alfabeto	l'alphabet
algoritmos	algorithmes
alianza	alliance
alianzas	alliances
alimentada	alimentée
alimentadas	alimentées
alimentaria	alimentaire
alineamiento	l'alignement
alineamientos	alignements
alinea	s'aligne
alquimistas	alchimistes
altamente	hautement
alterna	alterne
alternan	alternent
alternancia	alternance
alternativa	alternative
alternativas	alternatives
aluminio	d'aluminium
alvéolos	alvéoles
amalgama	amalgame
amarrado	amarré
ambiciones	ambitions
ambiguo	ambigu
ambulancias	ambulances
amenazar	menacer
amenazas	menaces
americanos	américains
amerindias	amérindiennes
amianto	l'amiante
amigas	amies
amoníaco	l'ammoniac
anales	annales
analista	analyste
analistas	analystes
analíticos	analytiques
analogía	analogie
analógicas	analogiques
analógicos	analogiques
anarquistas	anarchistes
ancestral	ancestrale
andaluces	andalous
andaluza	andalouse
anécdota	anecdote
anecdótico	anecdotique
anexos	annexes
ángeles	anges
angélica	angélique
anglicana	anglicane
anglicano	anglican
anglicanos	anglicans
angloamericana	anglo-américaine
anglófonos	anglophones
anglosajona	anglo-saxonne
anglosajón	anglo-saxon
anglosajonas	anglo-saxonnes
anglosajones	anglo-saxons
angular	angulaire
animaciones	animations
animados	animés
animal	animale
animales	animaux
aniversario	anniversaire
aniversarios	anniversaires
anomalía	anomalie
anomalías	anomalies
anómalo	anormal
anonimato	l'anonymat
anormalmente	anormalement
antagonistas	antagonistes
antenas	antennes
antibiótico	antibiotique
antibióticos	antibiotiques
anticapitalista	anticapitaliste
anticipa	anticipe
anticipada	anticipée
anticipadas	anticipées
anticipando	anticipant
anticipándose	anticipant
anticipar	anticiper
anticuerpos	anticorps
antifascista	antifasciste
antígenos	antigènes
antípodas	antipodes
antisemita	antisémite
antisemitas	antisémites
antisemitismo	l'antisémitisme
antropología	anthropologie
antropológico	anthropologique
antropológicos	anthropologiques
antropólogo	anthropologue
anual	annuel
anuales	annuels
aparentemente	apparemment
apariencias	apparences
apartamento	appartement
apartamentos	appartements
apasionados	passionnés
aplicables	applicables
aplicaciones	applications
apocalipsis	apocalypse
apocalíptico	apocalyptique
apología	l'apologie
aprenden	apprennent
apropiadas	appropriées
apropiados	appropriés
árabe	arabe
árabes	arabes
arbitraje	d'arbitrage
arbitraria	arbitraire
arbitrarias	arbitraires
arbitrario	arbitraire
arbitrarios	arbitraires
árbitros	arbitres
archipiélagos	archipels
archivos	archives
argentina	argentine
argentinas	argentines
argentino	argentin
argumentos	arguments
áridas	arides
aristocracias	aristocratiques
aristócratas	aristocrates
armadores	armateurs
armados	armés
armamentos	armements
armas	armes
armenio	arménien
armonía	harmonie
armoniosa	harmonieuse
aromas	arômes
arquitecto	architecte
arquitectos	architectes
arquitectura	architecture
arquitectura	l'architecture
arquitecturas	architectures
arrancados	arrachés
arrepentirse	repentir
arrestos	arrestations
arsenales	arsenaux
arsénico	l'arsenic
arterial	artérielle
arterias	artères
artesanado	l'artisanat
artesanal	artisanale
artesanales	artisanales
artesanía	l'artisanat
artesanos	artisans
articulación	articulation
articulada	articulée
articuladas	articulées
artículos	articles
artificial	artificielle
artificiales	artificielles
artificialmente	artificiellement
artillería	l'artillerie
artista	artiste
artista	l'artiste
artistas	artistes
artísticas	artistiques
artísticos	artistiques
asalariados	salariés
asamblea	assemblée
asambleas	assemblées
ascendientes	ascendants
ascensores	ascenseurs
asesinos	assassins
asilo	d'asile
asimétrica	asymétrique
asimétricas	asymétriques
asimétrico	asymétrique
asimétricos	asymétriques
asimiladas	assimilées
asimilados	assimilés
asistente	assistant
asistentes	assistants
asociaciones	associations
asociativa	associative
asociativas	associatives
asociativos	associatifs
aspectos	aspects
aspiraciones	aspirations
astronauta	astronaute
astronómica	astronomique
astronómicas	astronomiques
astronómico	astronomique
astronómicos	astronomiques
astrónomo	astronome
ataques	attaques
atentados	attentats
aterrizar	atterrir
aterrizó	atterri
atlánticas	atlantiques
atletas	athlètes
atmosférica	atmosphérique
atmosféricos	atmosphériques
átomos	atomes
atormentada	tourmentée
atormentado	tourmenté
atraen	attirent
atribuía	attribuait
atributos	attributs
atrocidades	atrocités
audiovisual	audiovisuel
audiovisuales	audiovisuels
auditiva	auditif
augurio	augure
augusto	auguste
aumentado	augmenté
aumentos	augmentations
ausencias	absences
ausente	absent
auspicios	auspices
Austral	australe
australianas	australiennes
australiano	australien
australianos	australiens
austriacos	autrichiens
autenticidad	l'authenticité
autismo	l'autisme
autobús	autobus
autobuses	autobus
autocares	autocars
autóctona	autochtone
autóctonas	autochtones
autóctonos	autochtones
autodeterminación	l'autodétermination
automática	automatique
automáticamente	automatiquement
automático	automatique
automáticos	automatiques
automatizada	automatisée
automatizado	automatisé
automóvil	automobile
automovilistas	automobilistes
autónomas	autonomes
autonomía	l'autonomie
autonomistas	autonomistes
autores	auteurs
autoridades	autorités
autoritaria	autoritaire
autoritario	autoritaire
autoritarios	autoritaires
autorizaba	autorisait
autorizaciones	autorisations
autorizado	autorisé
autorizados	autorisés
avalanchas	avalanches
aventura	aventure
aventuras	aventures
aversión	aversion
aviar	aviaire
avión	avion
axiomas	axiomes
bacilo	bacille
bacteria	bactérie
bacterianas	bactériennes
bacterias	bactéries
balance	bilan
balances	bilans
balanza	balance
balas	balles
balcón	balcons
balísticos	balistiques
ballenas	baleines
balón	ballon
balones	ballons
bancaria	bancaire
bancarias	bancaires
bancario	bancaire
bancarios	bancaires
bandidos	bandits
banquero	banquier
banqueros	banquiers
barba	barbe
bárbara	barbare
barómetro	baromètre
barón	baron
barones	barons
barras	barres
barreras	barrières
barricadas	barricades
barril	baril
barriles	barils
basilisco	basilic
bastiones	bastions
batalla	bataille
batallas	batailles
batallón	bataillon
batallones	bataillons
batería	batterie
belga	belge
belgas	belges
bendición	bénédiction
benedictina	bénédictine
beneficiario	bénéficiaire
beneficiarios	bénéficiaires
benigna	bénigne
berlinés	berlinois
biblia	bible
bibliófilos	bibliophiles
biblioteca	bibliothèque
bibliotecarios	bibliothécaires
bibliotecas	bibliothèques
bicentenario	bicentenaire
bienal	biennale
Bienal	biennale
bienes	biens
bilaterales	bilatéraux
bilingüe	bilingue
billete	billet
billetes	billets
biodiversidad	biodiversité
bioética	bioéthique
biología	biologie
biológicas	biologiques
biológicos	biologiques
biomasa	biomasse
biotecnología	biotechnologie
biotecnologías	biotechnologies
bipolar	bipolaire
bivalvos	bivalves
bizantina	byzantine
bizantinas	byzantines
blanca	blanche
Blanco	blanc
blancos	blancs
blancura	blancheur
blindado	blindée
blindados	blindés
bloquea	bloque
bloqueada	bloquée
bloqueadas	bloquées
bloqueado	bloqué
bloqueados	bloqués
bloquean	bloquent
bloquear	bloquer
bloques	blocs
boicot	boycott
boicotear	boycotter
bolcheviques	bolcheviks
boletín	bulletin
boliviano	bolivien
bomba	bombe
bombardea	bombarde
bombardeada	bombardée
bombardeado	bombardé
bombardear	bombarder
bombardeo	bombardement
bombardeos	bombardements
bombardero	bombardier
bombarderos	bombardiers
bombas	bombes
bordean	bordent
boreal	boréale
bosnio	bosniaque
botas	bottes
botella	bouteille
botellas	bouteilles
bovino	bovine
bovinos	bovins
boxeador	boxeur
boxeadores	boxeurs
brasileña	brésilien
brasileño	brésilien
brasileños	brésiliens
brevemente	brièvement
bricolaje	bricolage
brigada	brigade
brigada	brigadier
brigadas	brigades
brilla	brille
bromuro	bromure
bronce	bronze
Bronce	bronze
brutal	brutale
brutalidad	brutalité
brutalmente	brutalement
bucle	boucle
bucles	boucles
budismo	bouddhisme
budistas	bouddhistes
bufón	bouffon
bulevares	boulevards
búlgara	bulgare
búlgaro	bulgare
búlgaros	bulgares
búnker	bunker
burguesa	bourgeoise
burgueses	bourgeois
cabina	cabine
cabinas	cabines
cable	câble
cadáver	cadavre
cadáveres	cadavres
cadmio	cadmium
calcio	calcium
calculada	calculée
calculado	calculé
calculadora	calculatrice
cálculo	calcul
cálculos	calculs
caldero	chaudron
calendario	calendrier
calendarios	calendriers
calificativos	qualificatifs
californiana	californienne
californiano	californien
calor	chaleur
calorías	calories
calvario	calvaire
camaradas	camarades
camerunés	camerounais
camión	camion
camiones	camions
camioneta	camionnette
camisas	chemises
campaña	campagne
campañas	campagnes
campeonato	championnat
campeonatos	championnats
campeón	champion
canadiense	canadien
canadienses	canadiens
canalización	canalisation
canalizaciones	canalisations
cáncer	cancer
canciller	chancelier
canciones	chansons
candidata	candidate
candidato	candidat
candidatos	candidats
candidatura	candidature
candidaturas	candidatures
canibalismo	cannibalisme
cañones	canons
canonización	canonisation
cantan	chantent
cantantes	chanteurs
cantó	chanté
cantón	canton
cantones	cantons
cantor	chantre
capacidad	capacité
capacidades	capacités
capillas	chapelles
capitales	capitaux
capitalismo	capitalisme
capitalista	capitaliste
capitalistas	capitalistes
capitalización	capitalisation
capitán	capitaine
capitanes	capitaines
capitulación	capitulation
capitular	capituler
caprichos	caprices
capturadas	capturées
carabineros	carabiniers
caracteres	caractères
características	caractéristiques
caracteriza	caractérise
caracterización	caractérisation
caracterizan	caractérisent
caracterizar	caractériser
caravana	caravane
caravanas	caravanes
carbón	charbon
carbones	charbons
carbono	carbone
carburantes	carburants
cardiacas	cardiaques
Cardiología	cardiologie
carga	charge
cargas	charges
carguero	cargo
caribeño	caribéenne
caricatura	caricature
carisma	charisme
carismático	charismatique
caritativa	caritative
caritativas	caritatives
carnívoros	carnivores
carrera	carrière
carrocería	carrosserie
carrusel	carrousel
cártel	cartel
cartografía	cartographie
cartuchos	cartouches
cascada	cascade
casta	caste
castas	castes
cataclismo	cataclysme
catalana	catalane
catalán	catalan
catalanes	catalans
catálogos	catalogues
catastro	cadastre
catástrofe	catastrophe
catástrofes	catastrophes
catecismo	catéchisme
catedral	cathédrale
catedrales	cathédrales
categoría	catégorie
categorías	catégories
categóricamente	catégoriquement
catorce	quatorze
caverna	caverne
ceden	cèdent
celular	cellulaire
células	cellules
celulosa	cellulose
cemento	ciment
censor	censeur
censura	censure
censurada	censurée
centenario	centenaire
centenarios	centenaires
centésima	centième
centímetro	centimètre
céntimos	centimes
centinelas	sentinelles
central	centrale
Central	centrale
centralizada	centralisée
centralizado	centralisé
centralizador	centralisateur
centrista	centriste
Centroafricana	centrafricaine
centro	centre
centros	centres
cereales	céréales
cerebral	cérébrale
cerebrales	cérébrales
ceremonia	cérémonie
ceremonial	cérémonial
ceremonias	cérémonies
cerezas	cerises
certezas	certitudes
certificación	certification
certificada	certifiée
certificado	certificat
certificados	certificats
champán	champagne
chantaje	chantage
cheque	chèque
cheques	chèques
chiíta	chiite
chiítas	chiites
chilena	chilienne
chileno	chilien
chilenos	chiliens
chinas	chinoises
chino	chinois
chinos	chinois
chipriota	chypriote
chocolate	chocolat
choques	chocs
cianuro	cyanure
ciclismo	cyclisme
ciclistas	cyclistes
ciclos	cycles
ciencia	science
ciencias	sciences
científicos	scientifiques
cierta	certaine
cifras	chiffres
cineastas	cinéastes
cinética	cinétique
cinismo	cynisme
cinturón	ceinture
cinturones	ceintures
circuito	circuit
circuitos	circuits
circulaban	circulaient
circulación	circulation
circula	circule
circulado	circulé
circular	circuler
circuncidado	circoncision
circunscripción	circonscription
circunscripciones	circonscriptions
circunstancias	circonstances
cisternas	citernes
citar	citer
Civiles	civiles
civiles	civils
civilización	civilisation
civilizaciones	civilisations
clandestina	clandestine
clandestinamente	clandestinement
clandestinidad	clandestinité
clandestino	clandestin
clandestinos	clandestins
clanes	clans
claramente	clairement
claras	claires
claros	clairs
clases	classes
clasificación	classification
clavos	clous
clemencia	clémence
clero	clergé
cliente	client
clientela	clientèle
clientes	clients
clima	climat
climas	climats
climatología	climatologie
cloro	chlore
cloruro	chlorure
clubes	clubs
coalición	coalition
coaliciones	coalitions
coautor	coauteur
coautor	co-auteur
cobalto	cobalt
cobertura	couverture
cocaína	cocaïne
cocodrilo	crocodile
cocodrilos	crocodiles
codificación	codification
codificada	codifiée
coeficientes	coefficients
coexistencia	coexistence
coexisten	coexistent
cognitivas	cognitives
cognitivos	cognitifs
coherencia	cohérence
coherente	cohérente
cohesión	cohésion
colaboradores	collaborateurs
colecciones	collections
colectiva	collective
colectivamente	collectivement
colectivas	collectives
colectividad	collectivité
colectividades	collectivités
colectivización	collectivisation
colectivo	collectif
colectivos	collectives
colesterol	cholestérol
colina	colline
colinas	collines
colisión	collision
colisiones	collisions
colombiana	colombienne
colombiano	colombien
colon	côlon
colonia	colonie
colonial	coloniale
colonialismo	colonialisme
colonias	colonies
colonización	colonisation
colonizado	colonisé
colonizador	colonisateur
colonizar	coloniser
colonos	colons
coloquio	colloque
coloración	coloration
colorantes	colorants
color	couleur
colores	couleurs
colorido	coloré
coloso	colosse
colusión	collusion
comandante	commandant
comandantes	commandants
comando	commando
combates	combats
combatientes	combattants
combatividad	combativité
combinaciones	combinaisons
combina	combine
combinada	combinée
combinado	combiné
combinando	combinant
combinar	combiner
combustión	combustion
comediantes	comédiens
comentaristas	commentateurs
comercial	commerciale
comerciales	commerciales
comerciales	commerciaux
comercialización	commercialisation
comercializada	commercialisée
comercializadas	commercialisées
comercializado	commercialisé
comercializados	commercialisés
comercializar	commercialiser
comercialmente	commercialement
comercio	commerce
cometer	commettre
comisarios	commissaires
comisión	commission
comisiones	commissions
Comité	comité
comparaciones	comparaisons
comparar	comparer
comparativa	comparative
comparativo	comparative
comparten	partagent
compartimentos	compartiments
compasión	compassion
compatibilidad	compatibilité
compatriota	compatriote
compatriotas	compatriotes
compensación	compensation
compensaciones	compensations
compensada	compensée
compensar	compenser
competencias	compétences
competente	compétente
competentes	compétentes
competiciones	compétitions
competitiva	compétitive
competitividad	compétitivité
competitivo	compétitif
compleja	complexe
complejas	complexes
complejidad	complexité
complejo	complexe
complejos	complexes
complementan	complètent
complementar	compléter
complementaria	complémentaire
complementarias	complémentaires
complementariedad	complémentarité
complemento	complément
complementos	compléments
completa	complète
complicaciones	complications
complicar	compliquer
cómplice	complice
cómplices	complices
complicidad	complicité
componen	composent
comportamiento	comportement
comportamientos	comportements
composición	composition
composiciones	compositions
compositor	compositeur
compositores	compositeurs
comprender	comprendre
comprensible	compréhensible
comprensión	compréhension
compresión	compression
comprometer	compromettre
compromiso	compromis
compuestos	composés
común	commune
comunes	communes
comunicación	communication
comunicaciones	communications
comunismo	communisme
Comunista	communiste
comunistas	communistes
comunitaria	communautaire
comunitarias	communautaires
comunitario	communautaire
comunitarios	communautaires
comúnmente	communément
coñac	cognac
concentración	concentration
concentraciones	concentrations
concentrado	concentré
concéntricos	concentriques
concepción	conception
concepciones	conceptions
concepto	concept
conceptos	concepts
concertación	concertation
concertada	concertée
concesionario	concessionnaire
concesionarios	concessionnaires
concesiones	concessions
conciencia	conscience
conciencias	consciences
conciertos	concerts
conciliación	conciliation
conciliar	concilier
concisa	concise
cónclave	conclave
Cónclave	conclave
concluir	conclure
conclusión	conclusion
conclusiones	conclusions
concordia	concorde
concretas	concrètes
concretos	concrets
condecoraciones	décorations
condenan	condamnent
condenando	condamnant
condenar	condamner
condensación	condensation
condicionada	conditionnée
condicional	conditionnel
condicionamiento	conditionnement
condición	condition
condiciones	conditions
condolencias	condoléances
conducta	conduite
conductividad	conductivité
conductor	conducteur
conductores	conducteurs
conectividad	connectivité
conector	connecteur
confederación	confédération
Confederaciones	confédérations
Confederal	confédéral
conferencia	conférence
Conferencia	conférence
conferencias	conférences
confianza	confiance
confidencialidad	confidentialité
confiere	confère
confieren	confèrent
confinamiento	confinement
confirmación	confirmation
confirma	confirme
confirmada	confirmée
confirmadas	confirmées
confirmado	confirmé
confirman	confirment
confirmando	confirmant
confirmar	confirmer
confirmó	confirmé
confiscación	confiscation
confiscadas	confisqués
confiscados	confisqués
confiscar	confisquer
conflicto	conflit
conflictos	conflits
confrontación	confrontation
confrontaciones	confrontations
confrontar	confronter
confusión	confusion
confusiones	confusions
congestión	congestion
congoleño	congolais
congoleños	congolais
congreso	congrès
conmemoración	commémoration
conmemoraciones	commémorations
conmemorativas	commémoratives
connotación	connotation
connotaciones	connotations
conquista	conquête
conquistada	conquise
conquistado	conquis
consagración	consécration
consecuencias	conséquences
consecutivo	consécutive
consecutivos	consécutives
consejeros	conseillers
consejo	conseil
consejos	conseils
consenso	consensus
consentimiento	consentement
conservación	conservation
conservadora	conservatrice
conservadoras	conservatrices
conservador	conservateur
Conservador	conservateur
conservadores	conservateurs
conservadurismo	conservatisme
conservas	conserves
considerables	considérables
consideraciones	considérations
considerados	considérés
considerando	considérant
consistido	consisté
consolidación	consolidation
consolidada	consolidée
consolidado	consolidé
consolidar	consolider
conspiración	conspiration
conspiradores	conspirateurs
constelación	constellation
constitucional	constitutionnel
Constitucional	constitutionnel
constitucionales	constitutionnelles
Constitucionales	constitutionnelles
constitucionalidad	constitutionnalité
constitución	constitution
constituciones	constitutions
constituidos	constitués
construcción	construction
constructiva	constructive
construidos	construits
construir	construire
consulado	consulat
consulados	consulats
consular	consulaire
consulares	consulaires
cónsul	consul
cónsules	consuls
consulta	consultation
consultado	consulté
consultados	consultés
consultar	consulter
consultas	consultations
consultivo	consultatif
Consultivo	consultatif
consultor	consultant
consultores	consultants
consumen	consomment
consumir	consommer
contabilidad	comptabilité
contable	comptable
contables	comptables
contacto	contact
contactos	contacts
contaminadas	contaminées
contaminados	contaminés
contemporánea	contemporaine
contemporáneas	contemporaines
contemporáneo	contemporain
contemporáneos	contemporains
contenedor	conteneur
contenedores	conteneurs
contener	contenir
contenido	contenu
contexto	contexte
contextos	contextes
contiene	contient
contiguo	contigu
continental	continentale
continentales	continentaux
continente	continent
continentes	continents
contingente	contingent
contingentes	contingents
continuados	continus
continuidad	continuité
contornos	contours
contrabando	contrebande
contracción	contraction
contra	contre
contracorriente	contre-courant
contractuales	contractuelles
contradicción	contradiction
contradicciones	contradictions
contradictoria	contradictoire
contradictorias	contradictoires
contradictorio	contradictoire
contradictorios	contradictoires
contrapartida	contrepartie
contrapeso	contrepoids
contrarias	contraires
contrarreforma	contre-réforme
contrasta	contraste
contrato	contrat
contratos	contrats
contribución	contribution
contribuciones	contributions
contribuido	contribué
contribuirá	contribuera
contribuir	contribuer
contribuye	contribue
contribuyen	contribuent
contribuyente	contribuable
contribuyentes	contribuables
controladas	contrôlées
controlado	contrôlé
controladores	contrôleurs
controlados	contrôlés
controlan	contrôlent
controlar	contrôler
control	contrôle
controles	contrôles
controversia	controverse
controvertida	controversée
controvertidas	controversées
controvertido	controversé
controvertidos	controversés
convencer	convaincre
convencidos	convaincus
convencional	conventionnelle
convencionales	conventionnelles
convenciones	conventions
Convenio	convention
convenios	conventions
convergencia	convergence
convergen	convergent
conversión	conversion
conversiones	conversions
convertidor	convertisseur
convertidores	convertisseurs
convicción	conviction
convicciones	convictions
convocar	convoquer
convoy	convoi
convoyes	convois
convulsiones	convulsions
cooperación	coopération
cooperaciones	coopérations
cooperar	coopérer
cooperativa	coopérative
Cooperativa	coopérative
cooperativas	coopératives
coordinación	coordination
coordinador	coordinateur
coordinar	coordonner
copia	copie
copiada	copié
copiar	copier
copias	copies
coproducción	coproduction
coptos	coptes
coral	corail
cordón	cordon
coreana	coréenne
coreanas	coréennes
coreano	coréen
corolario	corollaire
corona	couronne
coronas	couronnes
coronel	colonel
coroneles	colonels
corporación	corporation
corporales	corporels
corrección	correction
correcciones	corrections
correctamente	correctement
corredores	corridors
corregidos	corrigés
corregir	corriger
correlación	corrélation
correlaciones	corrélations
correo	courrier
correspondencia	correspondance
corrosión	corrosion
corrupción	corruption
corruptos	corrompus
corsarios	corsaires
corsé	corset
corso	corse
corta	courte
cortejo	cortège
cortesanos	courtisans
corto	court
cosmética	cosmétique
cosmético	cosmétique
cosméticos	cosmétiques
cosmopolita	cosmopolite
costar	coûter
coste	coût
costeros	côtiers
costumbres	coutumes
cotizaciones	cotisations
cowboy	cow-boy
creaciones	créations
crear	créer
creativa	créative
creativas	créatives
creativos	créatifs
credibilidad	crédibilité
crédito	crédit
creíble	crédible
cremas	crèmes
crepúsculo	crépuscule
criaturas	créatures
crimen	crime
crímenes	crimes
criminal	criminel
criminales	criminels
crisis	crise
cristalización	cristallisation
cristaliza	cristallise
cristianismo	christianisme
criterio	critère
criterios	critères
critican	critiquent
criticar	critiquer
croata	croate
croatas	croates
cromo	chrome
cronológico	chronologique
cronómetro	chronomètre
crucifijo	crucifix
crucifijos	crucifix
cuadratura	quadrature
cualificaciones	qualifications
cualificación	qualification
cualificados	qualifiés
cualitativa	qualitative
cualitativas	qualitatives
cualitativo	qualitatif
cuantificación	quantification
cuantificar	quantifier
cuantitativa	quantitative
cuantitativas	quantitatives
cuartas	quarts
cuaternario	quaternaire
cuatro	quatre
cubana	cubaine
cubano	cubain
cubanos	cubains
cubiertos	couverts
cubren	couvrent
cubrir	couvrir
cuestionario	questionnaire
cuestiones	questions
cuestión	question
culinaria	culinaire
culinarias	culinaires
culinario	culinaire
culinarios	culinaires
culpabilidad	culpabilité
culpable	coupable
cultivadas	cultivées
cultivado	cultivé
cultivados	cultivés
cultivar	cultiver
culto	culte
cultura	culture
cultural	culturelle
culturales	culturelles
culturales	culturels
culturalmente	culturellement
culturas	cultures
cuotas	quotas
curiosamente	curieusement
cutánea	cutanée
danesas	danoises
danés	danois
datados	datés
debate	débat
debates	débats
decantación	décantation
decenios	décennies
decepción	déception
decide	décide
deciden	décident
decidir	décider
decisión	décision
decisiones	décisions
decisivas	décisives
decisivo	décisif
declaración	déclaration
declaraciones	déclarations
declarar	déclarer
decorativas	décoratives
decorativo	décoratif
decorativos	décoratifs
decreto	décret
decretos	décrets
deducción	déduction
defección	défection
defenderá	défendra
defender	défendre
defendía	défendait
defensa	défense
defensas	défenses
defensiva	défensive
defensivas	défensives
defensivo	défensif
defensivos	défensifs
defensor	défenseur
defensores	défenseurs
deficitaria	déficitaire
deficitario	déficitaire
definición	définition
definiciones	définitions
definido	défini
definidos	définis
definir	définir
definitiva	définitive
definitivamente	définitivement
definitivas	définitives
definitivo	définitif
deforestación	déforestation
degradación	dégradation
degradados	dégradés
degradan	dégradent
degustación	dégustation
delegaciones	délégations
deliberaciones	délibérations
deliberadamente	délibérément
delimitación	délimitation
delimitaciones	délimitations
delimitadas	délimitées
delimitado	délimité
delirios	délires
demarcación	démarcation
demencia	démence
democracia	démocratie
democracias	démocraties
demócrata	démocrate
demócratas	démocrates
democráticamente	démocratiquement
democratización	démocratisation
demoler	démolir
demolición	démolition
demostración	démonstration
demostraciones	démonstrations
denominador	dénominateur
densamente	densément
densidad	densité
dentales	dentaires
dentista	dentiste
dentistas	dentistes
deontología	déontologie
deontológico	déontologie
departamento	département
departamentos	départements
depende	dépend
dependencia	dépendance
dependen	dépendent
dependerá	dépendra
deplorable	déplorable
deportación	déportation
deportaciones	déportations
deportados	déportés
deporte	sport
deportiva	sportive
deportivas	sportives
deportivos	sportifs
depositario	dépositaire
depresión	dépression
depresiones	dépressions
depresivo	dépressif
derivas	dérives
derogación	dérogation
desacreditar	discréditer
desacuerdos	désaccords
desaparición	disparition
desapariciones	disparitions
desaprobación	désapprobation
desarmar	désarmer
desarme	désarmement
desastrosa	désastreuse
desastrosas	désastreuses
desbloquear	débloquer
descalificación	disqualification
descendientes	descendants
descentralización	décentralisation
descolonización	décolonisation
descomposición	décomposition
desconstrucción	déconstruction
descripción	description
descripciones	descriptions
descritas	décrites
descritos	décrits
desertor	déserteurs
desesperadamente	désespérément
desestabilización	déstabilisation
desestabilizar	déstabiliser
desfavorable	défavorable
desfavorables	défavorables
desfilar	défiler
deshidratación	déshydratation
desierto	désert
desiertos	déserts
designaba	désignait
designación	désignation
designados	désignés
designar	désigner
designio	dessein
desinfección	désinfection
desinformación	désinformation
desintegración	désintégration
deslocalización	délocalisation
desmantelado	démantelé
desmantelamiento	démantèlement
desmantelar	démanteler
desmembramiento	démembrement
desmentido	démenti
desmiente	dément
desmontaje	démontage
desorden	désordre
desorganización	désorganisation
déspota	despote
despotismo	despotisme
destilación	distillation
destinatario	destinataire
destinos	destinations
destrucción	destruction
destructiva	destructrice
destructivo	destructeur
destructivos	destructeurs
destruidos	détruits
destruir	détruire
detalles	détails
detección	détection
detectores	détecteurs
deteriora	détériore
determinación	détermination
determinante	déterminant
determinantes	déterminants
determinar	déterminer
detractores	détracteurs
detrimento	détriment
devaluación	dévaluation
devastador	dévastateur
devora	dévore
devorar	dévorer
diabetes	diabète
diagnosticar	diagnostiquer
diagnóstico	diagnostic
diagnósticos	diagnostics
diagrama	diagramme
dialéctica	dialectique
dialecto	dialecte
diálogo	dialogue
diálogos	dialogues
diamante	diamant
diamantes	diamants
diáspora	diaspora
diccionario	dictionnaire
diccionarios	dictionnaires
diciembre	décembre
dicotomía	dichotomie
dictador	dictateur
dictadura	dictature
dictaduras	dictatures
dientes	dents
difamación	diffamation
diferenciación	différenciation
diferenciadas	différenciées
diferencia	différence
diferenciado	différencié
diferencial	différentiel
diferencias	différences
difícil	difficile
difíciles	difficiles
difícilmente	difficilement
dificultad	difficulté
dificultades	difficultés
difracción	diffraction
difunta	défunte
difusión	diffusion
digestivo	digestif
dignatarios	dignitaires
dignidad	dignité
dignidades	dignités
dilema	dilemme
diligencia	diligence
dimensión	dimension
dimisión	démission
dinamismo	dynamisme
dinamita	dynamite
dinamizar	dynamiser
dinosaurios	dinosaures
diplomacia	diplomatie
diplomas	diplômes
diplomática	diplomatique
diplomáticas	diplomatiques
diplomático	diplomatique
diplomáticos	diplomatiques
diputación	députation
diques	digues
dirección	direction
direcciones	directions
Direcciones	directions
directa	directe
directamente	directement
directas	directes
directiva	directive
Directiva	directive
directivas	directives
directo	direct
director	directeur
Director	directeur
directores	directeurs
directos	directs
directriz	directrice
dirigentes	dirigeants
discernir	discerner
disciplinarias	disciplinaires
disciplinario	disciplinaire
disciplinarios	disciplinaires
disciplinas	disciplines
discípulo	disciple
discípulos	disciples
discontinuidad	discontinuité
discordia	discorde
discoteca	discothèque
discotecas	discothèques
discreto	discret
discretos	discrets
discriminación	discrimination
discriminaciones	discriminations
discurso	discours
disentería	dysenterie
disfunciones	dysfonctionnements
disidencia	dissidence
disidentes	dissidents
disminución	diminution
disolución	dissolution
disolvente	solvant
disolventes	solvants
disparidades	disparités
dispersar	disperser
dispersión	dispersion
dispersos	dispersés
disponibilidad	disponibilité
disposición	disposition
disposiciones	dispositions
dispositivos	dispositifs
disputada	disputée
disputan	disputent
disquete	disquettes
distancia	distance
distancias	distances
distinción	distinction
distinguiendo	distinguant
distorsión	distorsion
distorsiones	distorsions
distribución	distribution
distribuida	distribué
distribuidor	distributeur
distribuidores	distributeurs
distribuir	distribuer
disuadir	dissuader
disuasión	dissuasion
divergencia	divergence
diversidad	diversité
diversificación	diversification
diversificada	diversifiée
diversificar	diversifier
divide	divise
dividendos	dividendes
dividir	diviser
divina	divine
divinas	divines
divisas	devises
división	division
divisiones	divisions
divorciado	divorcé
divorciados	divorcés
divorcio	divorce
dobladas	doublés
doblaje	doublage
doble	double
dócil	docile
doctorado	doctorat
doctrina	doctrine
doctrinas	doctrines
documentadas	documentées
documentados	documentés
documental	documentaire
documentales	documentaires
documento	document
documentos	documents
dogmas	dogmes
dólar	dollar
dólares	dollars
dolor	douleur
dolorosas	douloureuses
domesticación	domestication
domésticos	domestiques
domicilio	domicile
dominación	domination
dominada	dominée
dominadas	dominées
dominado	dominé
dominados	dominés
dominan	dominent
Dominicana	dominicaine
donantes	donateurs
dopaje	dopage
dormido	endormi
dotar	doter
drama	drame
dramas	drames
dramáticas	dramatiques
dramáticos	dramatiques
droga	drogue
drogas	drogue
drogas	drogues
duermen	dorment
dulce	douce
dunas	dunes
durar	durer
economías	économies
economista	économiste
economistas	économistes
Ecuatorial	équatoriale
ecuatoriano	équatorien
ediciones	éditions
ediles	édiles
editorialista	éditorialiste
educativo	éducatif
educativos	éducatifs
efecto	effet
efectos	effets
efervescencia	effervescence
eficaces	efficaces
eficaz	efficace
efigies	effigies
ejecuciones	exécutions
ejecutiva	exécutive
ejemplar	exemplaire
ejemplo	exemple
ejemplos	exemples
ejercicio	exercice
ejercicios	exercices
elecciones	élections
electoral	électorale
electores	électeurs
electrificación	l'électrification
electrodos	électrodes
electromagnética	électromagnétique
electromagnético	électromagnétique
electromagnéticos	électromagnétiques
electrones	d'électrons
elegante	élégante
elementales	élémentaires
elemento	élément
elementos	éléments
élite	l'élite
elites	élites
emancipación	l'émancipation
emboscada	embuscade
embrionaria	embryonnaire
embrionario	embryonnaire
embriones	embryons
emergente	émergente
emergentes	émergents
emigran	émigrent
eminente	éminent
eminentemente	éminemment
eminentes	éminents
emisiones	émissions
emociones	émotions
empleador	employeur
empleadores	employeurs
empleo	l'emploi
enanos	nains
encarnación	l'incarnation
encarna	incarne
encarnar	incarner
enciclopedia	encyclopédie
encuadradas	encadrées
endémica	endémique
endémicas	endémiques
endémico	endémique
endémicos	endémiques
enemigos	ennemis
energética	énergétique
energéticas	énergétiques
energéticos	énergétiques
enriquecer	enrichir
enriquecido	enrichi
ensalada	salade
ensaladas	salades
enteras	entières
enteros	entiers
enterrada	enterrée
enterradas	enterrées
entrará	entrera
entusiasta	enthousiaste
enviados	envoyés
enzimas	enzymes
epicentro	l'épicentre
epidemias	épidémies
Episcopado	l'épiscopat
Episcopal	épiscopale
episodio	épisode
episodios	épisodes
epistolar	épistolaire
equilibrada	équilibrée
equilibrado	équilibré
equilibrio	équilibre
equilibrios	équilibres
equipar	équiper
equipo	équipe
equivalencia	l'équivalence
equivalentes	équivalentes
errante	errant
error	erreur
errores	erreurs
erupciones	éruptions
esbirros	sbires
escandalosa	scandaleuse
escándalo	scandale
escándalos	scandales
escandinava	scandinave
escandinavo	scandinave
escandinavos	scandinaves
escanear	scanner
escáner	scanner
escenarios	scénarios
escepticismo	scepticisme
esclava	esclave
esclavistas	esclavagistes
esclavo	esclave
esclavos	esclaves
esclerosis	sclérose
escolares	scolaires
escolarización	scolarisation
escolarizados	scolarisés
escolar	scolaire
escribientes	scribes
escrito	écrit
escritos	écrits
escrupulosamente	scrupuleusement
escrúpulos	scrupules
escuadrones	escadrons
esculturas	sculptures
esenciales	essentiels
eslava	slave
eslavas	slaves
eslóganes	slogans
esotéricos	ésotériques
espaciales	spatiales
espacial	spatiale
Espacial	spatiale
espacios	espaces
española	espagnole
españolas	espagnoles
españoles	espagnols
español	espagnol
especialista	spécialiste
especialistas	spécialistes
especialización	spécialisation
especializarse	spécialiser
especies	espèces
especificaciones	spécifications
especificidades	spécificités
especificidad	spécificité
especímenes	spécimens
espectaculares	spectaculaires
espectacular	spectaculaire
espectáculo	spectacle
espectadores	spectateurs
espectador	spectateur
espectro	spectre
espectros	spectres
especulaciones	spéculations
especulativa	spéculative
esperma	sperme
espiral	spirale
espirituales	spirituels
espiritualidad	spiritualité
espiritual	spirituel
espontáneamente	spontanément
espontánea	spontanée
espontáneas	spontanées
espontaneidad	spontanéité
estabilidad	stabilité
estabilización	stabilisation
estabilizar	stabiliser
estables	stables
estable	stable
establos	étables
estacionamiento	stationnement
estacionario	stationnaire
estalinismo	stalinisme
estalinista	stalinien
estatuas	statues
estatua	statue
estatutaria	statutaire
estatutos	statuts
Estatutos	statuts
estatuto	statut
este-oeste	est-ouest
ésteres	esters
estériles	stériles
esterilización	stérilisation
estéril	stérile
esterlinas	sterling
esteroides	stéroïdes
estética	esthétique
estéticas	esthétiques
estético	esthétique
estéticos	esthétiques
estimaciones	estimations
estimulante	stimulant
estival	estivale
estrategas	stratèges
estratega	stratège
estrategias	stratégies
estrategia	stratégie
estratégicas	stratégiques
estratégica	stratégique
estratégicos	stratégiques
estratégico	stratégique
estratificación	stratification
estrés	stress
estrictamente	strictement
estrictas	strictes
estricta	stricte
estricto	strict
estructuración	structuration
estructuradas	structurées
estructurada	structurée
estructurados	structurés
estructurado	structuré
estructurales	structurels
Estructurales	structurels
estructural	structurelle
estructurar	structurer
estructuras	structures
estructura	structure
estuarios	estuaires
estudiante	étudiant
estudiantes	étudiants
estupor	stupeur
etanol	l'éthanol
etapas	étapes
etiquetas	étiquettes
etnias	ethnies
europeas	européennes
europeo	européen
Europeo	européen
europeos	européens
eutanasia	l'euthanasie
evaluaciones	évaluations
Evangélica	évangélique
evangélicas	évangéliques
evitando	évitant
evolutivo	évolutif
exactamente	exactement
exámenes	examens
excéntrica	excentrique
excentricidad	excentricité
excepcionales	exceptionnelles
excepciones	exceptions
excesiva	excessive
excesivas	excessives
excesos	excès
excluida	exclue
excluidas	exclues
excluido	exclu
excluidos	exclus
exclusión	l'exclusion
exclusiva	exclusive
exclusivas	exclusives
excluyendo	excluant
excusas	excuses
exentos	exemptés
exigencias	exigences
exilado	exilé
exiliados	exilés
existencia	l'existence
expatriados	expatriés
experiencias	expériences
experimental	expérimentale
experta	experte
experto	expert
expertos	experts
expiración	l'expiration
explicaciones	explications
explicación	explication
explicar	expliquer
explícita	explicite
explícitamente	explicitement
explícitas	explicites
explora	explore
explosiones	explosions
explosión	explosion
explosión	l'explosion
explosiva	explosive
explosivas	explosives
explosivos	explosifs
explotables	exploitables
explotaciones	exploitations
explotación	l'exploitation
explotada	exploitée
explotado	exploité
explotados	exploités
explotan	exploitent
exponencial	exponentielle
exportaciones	exportations
exportadas	exportées
exportadores	exportateurs
exportador	exportateur
exportados	exportés
exporta	exporte
exposiciones	expositions
expresamente	expressément
expulsados	expulsés
expulsiones	expulsions
exteriores	extérieures
exterminación	l'extermination
externo	externe
externos	externes
extracción	l'extraction
extracto	extrait
extractos	extraits
extranjeros	étrangers
extraordinaria	extraordinaire
extraordinarias	extraordinaires
extraordinario	extraordinaire
extraordinarios	extraordinaires
extremas	extrêmes
extremista	extrémiste
extremistas	extrémistes
extremos	extrêmes
fabricación	fabrication
fabricante	fabricant
facciones	factions
facción	faction
facetas	facettes
fachadas	façades
facial	faciale
fácil	facile
facilitar	faciliter
fácilmente	facilement
factores	facteurs
factor	facteur
facturación	facturation
facturas	factures
facultativa	facultative
facultativo	facultatif
familia	famille
familiarizarse	familiariser
familias	familles
famosas	fameuses
fanatismo	fanatisme
fantasma	fantôme
fantásticas	fantastiques
fantásticos	fantastiques
farmacia	pharmacies
farmacias	pharmacies
farmacología	pharmacologie
farmacopea	pharmacopée
fascinación	fascination
fascinado	fasciné
fascismo	fascisme
fascista	fasciste
fascistas	fascistes
fatal	fatale
fatalidad	fatalité
fauna	faune
favorecer	favoriser
favores	faveurs
favorito	favori
favoritos	favoris
federaciones	fédérations
federales	fédérales
federal	fédéral
federal	fédérale
federalismo	fédéralisme
federalista	fédéraliste
federalistas	fédéralistes
felicitado	félicité
felicitar	féliciter
felinos	félins
femeninas	féminines
feminismo	féminisme
feminista	féministe
feministas	féministes
fermentación	fermentation
ferroviarias	ferroviaires
fértiles	fertiles
fértil	fertile
fertilidad	fertilité
fervor	ferveur
festín	festin
festivales	festivals
fetichismo	fétichisme
fiabilidad	fiabilité
fibra	fibres
fibras	fibres
ficciones	fictions
fichas	fiches
fichero	fichier
ficheros	fichiers
ficticias	fictives
fiebre	fièvre
fieles	fidèles
figurado	figuré
figurantes	figurants
filantropía	philanthropie
filial	filiale
filipinas	philippines
filipino	philippin
filipinos	philippins
filmado	filmé
filma	filme
filma	filmé
filtrada	filtré
filtro	filtre
filtros	filtres
finalistas	finalistes
financiada	financée
financiadas	financées
financiado	financé
financiados	financés
financia	finance
financiar	financer
financiera	financière
financieramente	financièrement
financieras	financières
financiero	financier
financieros	financiers
finanzas	finances
finas	fines
finés	finnois
finitos	finies
finlandesa	finlandaise
finlandesas	finlandaises
finlandeses	finlandais
finlandés	finlandais
fiscal	fiscale
fiscalidad	fiscalité
fisión	fission
fitosanitarias	phytosanitaires
flamencas	flamandes
flamencos	flamands
flanco	flanc
flanqueada	flanquée
flexibilidad	flexibilité
floración	floraison
flora	flore
floral	florale
flores	fleurs
florines	florins
flota	flotte
flotas	flottes
flotilla	flottille
fluctuaciones	fluctuations
fluctúa	fluctue
fluidos	fluides
folclore	folklore
fondos	fonds
formaciones	formations
formación	formation
formadores	formateurs
formador	formateur
formados	formés
formales	formelles
formalidades	formalités
formalidad	formalité
formalización	formalisation
formalmente	formellement
formas	formes
formato	format
formatos	formats
formulaciones	formulations
fórmula	formule
formulario	formulaire
formularios	formulaires
fórmulas	formules
foros	forums
fortificado	fortifié
fortificados	fortifiés
fortunas	fortunes
forzando	forçant
fosas	fosses
fósiles	fossiles
fósil	fossile
fotografiar	photographier
fotos	photos
fracciones	fractions
fractura	fracture
fracturas	fractures
fragata	frégate
fragatas	frégates
frágil	fragile
fragilidad	fragilité
fragmentación	fragmentation
fragmentaria	fragmentaire
fragmentario	fragmentaire
francamente	franchement
francas	franches
francés	français
franciscano	franciscain
franco-alemana	franco-allemande
franco-alemán	franco-allemand
francófonos	francophones
franco	franc
francos	francs
franquismo	franquisme
franquista	franquiste
frases	phrases
fraternal	fraternelle
fraternidad	fraternité
frecuencias	fréquences
frenada	freinage
frenos	freins
frío	froid
frontera	frontière
fronteras	frontières
fronterizos	frontaliers
fructosa	fructose
frustración	frustration
fruta	fruits
frutales	fruitiers
frutas	fruits
fruto	fruit
frutos	fruits
fuerte	forte
fugitivo	fugitif
fumar	fumer
funciona	fonctionne
funcionales	fonctionnels
funcionalidad	fonctionnalité
funcionamiento	fonctionnement
funcionar	fonctionner
funcionario	fonctionnaire
funcionarios	fonctionnaires
fundaciones	fondations
fundación	fondation
fundamentales	fondamentaux
fúnebres	funèbres
funeral	funérailles
furor	fureur
fusiles	fusils
fusionada	fusionnée
fusionado	fusionné
fusionando	fusionnent
fusionar	fusionner
fusiones	fusions
fusión	fusion
futura	future
futuras	futures
futuristas	futuristes
futuros	futurs
gabinete	cabinet
Gabinete	cabinet
galerías	galeries
galones	galons
galope	galop
gametos	gamètes
ganan	gagnent
ganar	gagner
gángster	gangster
garante	garant
garantía	garantie
garantías	garanties
garantiza	garantit
garantizar	garantir
gasoducto	gazoduc
gastronomía	gastronomie
gastronómica	gastronomique
gastronómicas	gastronomiques
gastronómico	gastronomique
gelatina	gélatine
gendarmería	gendarmerie
Gendarmería	gendarmerie
generaciones	générations
general	général
generalista	généraliste
generalistas	généralistes
genes	gènes
genéticamente	génétiquement
genios	génies
genocidio	génocide
genoma	génome
genomas	génomes
geométricas	géométriques
georgiano	géorgien
gérmenes	germes
germinación	germination
gestión	gestion
gesto	geste
gestores	gestionnaires
gestor	gestionnaire
gestos	gestes
gigante	géant
gigantes	géants
glaciares	glaciers
gladiadores	gladiateurs
globalidad	globalité
gloria	gloire
gloriosa	glorieuse
glucosa	glucose
gnomos	gnomes
gobernanza	gouvernance
gorilas	gorilles
graduación	graduation
grafito	graphite
gramo	gramme
gramos	grammes
granadas	grenades
grandeza	grandeur
granero	grenier
graneros	greniers
granos	grains
grasa	graisse
grasas	graisses
gratuidad	gratuité
gratuita	gratuite
gratuitamente	gratuitement
gratuitos	gratuits
gravemente	gravement
grial	graal
griegos	grecs
gripe	grippe
groseros	grossiers
grotesca	grotesque
grotesco	grotesque
grupo	groupe
grupos	groupes
guantes	gants
guardiana	gardienne
Guardianes	gardiens
guardián	gardien
guatemalteco	guatémaltèque
gubernamentales	gouvernementales
guerra	guerre
guerras	guerres
guerrera	guerrière
guerrilla	guérilla
guerrillas	guérillas
gueto	ghetto
guetos	ghettos
guiada	guidée
guiadas	guidées
guiado	guidé
guiar	guider
guillotina	guillotine
guiñol	guignol
habano	havane
hábilmente	habilement
habitada	habitée
habitadas	habitées
habitado	habité
habitante	habitant
habitantes	habitants
hábitat	habitats
hábitats	habitats
hachas	hache
hachas	haches
haitiano	haïtien
halcones	faucons
harina	farine
harinas	farines
hectárea	hectare
hectáreas	hectares
helicópteros	hélicoptères
herbicidas	herbicides
herbívoros	herbivores
hereditarias	héréditaires
héroe	héros
héroes	héros
heterogénea	hétérogène
heterogéneas	hétérogènes
heterogéneo	hétérogène
heterogéneos	hétérogènes
híbrida	hybride
híbridas	hybrides
híbrido	hybride
hidrocarburos	hydrocarbures
hierbas	herbes
hindúes	hindous
historiadores	historiens
historiador	historien
historias	histoires
históricamente	historiquement
históricas	historiques
históricos	historiques
holocausto	l'holocauste
hombre	homme
hombres	hommes
homenajes	hommages
homofobia	l'homophobie
homogénea	homogène
homogéneas	homogènes
homogéneo	homogène
homogéneos	homogènes
homologados	homologués
homólogo	homologue
homólogos	homologues
homosexuales	homosexuels
homosexualidad	l'homosexualité
honorario	honoraire
honorarios	honoraires
honores	honneurs
horarios	horaires
hordas	hordes
horizontales	horizontaux
horizontal	horizontale
horizontalmente	horizontalement
horizontes	horizons
hormigas	fourmis
hormona	hormone
hormonas	hormones
horrores	horreurs
hortícola	horticole
hospitalaria	hospitaliers
hospitalarias	hospitalières
hospital	hôpital
hospital	l'hôpital
hostil	hostile
hostilidades	hostilités
hoteles	hôtels
hulla	houille
humana	humaine
humanas	humaines
humanista	humaniste
humanistas	humanistes
humanitaria	humanitaire
humanitarias	humanitaires
humanitarios	humanitaires
humano	humain
humedales	humides
humildes	humbles
humores	humeurs
humoristas	humoristes
húngaro	hongrois
húngaros	hongrois
ibérica	ibérique
ibéricas	ibériques
iconos	icônes
ideal	idéal
idealista	idéaliste
idealmente	idéalement
ideas	idées
identidades	identités
identidad	identité
identificable	identifiable
identificada	identifiée
identificadas	identifiées
identificado	identifié
identificando	identifiant
ideologías	idéologies
ignorado	ignoré
ignorar	ignorer
ilegal	illégale
ilegalmente	illégalement
ilegítimas	illégitimes
ilícitas	illicites
ilícitos	illicites
ilimitada	illimitée
ilimitado	illimité
ilusorio	illusoire
ilustrado	illustré
ilustra	illustre
ilustran	illustrent
ilustres	illustres
imágenes	images
imaginaria	imaginaire
imaginarias	imaginaires
imaginario	imaginaire
imaginarios	imaginaires
imitaciones	imitations
imitando	imitant
imperativo	impératif
imperial	impériale
impermeable	imperméable
implantes	implants
implicaciones	implications
implícita	implicite
implícitamente	implicitement
implícito	implicite
impopular	impopulaire
importaciones	importations
importación	l'importation
importada	importée
importadas	importées
importado	importé
importador	importateur
importados	importés
importante	important
imposibilidad	l'impossibilité
imposible	impossible
imposibles	impossibles
impredecible	imprévisible
impresa	imprimée
impresionado	impressionné
impresionantes	impressionnants
impresión	l'impression
imprevisible	imprévisible
improvisaciones	improvisations
improvisadas	improvisée
impulsos	impulsions
impurezas	impuretés
inaccesible	inaccessible
inaccesibles	inaccessibles
inaceptable	inacceptable
inaugurada	inaugurée
incapaces	incapables
incapaz	incapable
incendian	incendient
incendiarias	incendiaires
incendios	incendies
incertidumbres	incertitudes
incidente	incident
incidentes	incidents
incierta	incertaine
incierto	incertain
incógnito	incognito
incoherencias	incohérences
incoloro	incolore
incompleta	incomplète
incompletas	incomplètes
incompleto	incomplet
incompletos	incomplètes
incomprensible	incompréhensible
incontrolable	incontrôlable
inconvenientes	inconvénients
increíble	incroyable
incursiones	incursions
indecisa	indécise
indefinidamente	indéfiniment
independencia	l'indépendance
independentista	indépendantiste
independentistas	indépendantistes
independiente	indépendante
independientes	indépendants
indeseables	indésirables
indias	indiennes
indicaciones	indications
indicadores	indicateurs
indicador	indicateur
indicativo	indicatif
indicativos	indicatifs
indiferencia	l'indifférence
indígenas	indigènes
indigno	indigne
indio	indien
indios	indiens
indirecta	indirecte
indirectamente	indirectement
indirectas	indirectes
indirectos	indirects
indisociable	indissociable
individualismo	l'individualisme
individualista	individualiste
individualmente	individuellement
individuos	individus
indoeuropea	indo-européenne
indonesio	indonésien
indonesios	indonésiens
inducidas	induites
industriales	industrielles
industriales	industriels
industria	l'industrie
industrial	industrielle
industrialización	l'industrialisation
industrializados	industrialisés
industrias	industries
inéditos	inédits
ineficaces	inefficaces
ineficaz	inefficace
inestabilidad	l'instabilité
inestable	instable
inestables	instables
inevitable	inévitable
inevitablemente	inévitablement
infecciones	infections
infecciosas	infectieuses
infectadas	infectées
infectados	infectés
infernal	infernale
infiel	infidèle
infiltrar	infiltrer
infiltrarse	infiltrer
infinita	infinie
infinitamente	infiniment
infinito	l'infini
inflamación	inflammation
inflamatorias	inflammatoires
influencia	influence
influencias	influences
influyentes	influents
informado	informé
informados	informés
informal	informel
informal	informelle
informante	informateur
infracciones	infractions
infraestructuras	infrastructures
infrarrojos	infrarouges
infructuosas	infructueuses
ingeniero	ingénieur
ingenieros	ingénieurs
ingrediente	ingrédient
ingredientes	ingrédients
inicialmente	initialement
iniciativa	initiative
iniciativas	initiatives
ininterrumpida	ininterrompue
injusta	injuste
injustamente	injustement
injusticias	injustices
injusto	injuste
inmediata	immédiate
inmediatamente	immédiatement
inmediatos	immédiats
inmigración	l'immigration
inminente	imminente
inmobiliaria	immobilière
inmobiliarias	immobilières
inmobiliario	immobilier
inmortales	immortels
inmunitario	immunitaire
innovación	l'innovation
innovadoras	innovantes
innovadores	innovants
inocentes	innocents
inorgánico	inorganique
inoxidable	inoxydable
inquisidor	inquisiteur
insatisfecho	insatisfait
inscritos	inscrits
insecticidas	insecticides
insecto	insecte
insectos	insectes
insistido	insisté
insoportable	insupportable
inspecciones	inspections
inspectores	inspecteurs
inspector	inspecteur
Inspector	l'inspecteur
inspirada	inspirée
inspiradas	inspirées
inspirado	inspiré
instalaciones	installations
instalada	installée
instalados	installés
Instancia	instance
instancias	instances
instantáneamente	instantanément
instigación	l'instigation
instigadores	instigateurs
instintos	instincts
institucionales	institutionnelles
institucional	institutionnel
institucional	institutionnelle
instituciones	institutions
institución	institution
instituto	institut
institutos	instituts
instrucciones	instructions
instrumento	instrument
instrumentos	instruments
insuficiencias	insuffisances
insulares	insulaires
insular	insulaire
insulto	insulte
insultos	insultes
insurgentes	insurgés
insurrección	l'insurrection
intacta	intacte
intactas	intactes
intacto	intact
integración	l'intégration
integrados	intégrés
integrante	intégrante
integrar	intégrer
intelectuales	intellectuels
intelectual	intellectuelle
inteligente	intelligente
intenciones	intentions
intensiva	intensive
intensivo	intensif
intensivos	intensifs
interacciones	interactions
interactiva	interactive
interactivas	interactives
interactivo	interactif
interactivos	interactifs
interactúa	interagit
interactuar	interagir
intercambiables	interchangeables
intercontinental	intercontinentale
interdisciplinaria	interdisciplinaire
interdisciplinario	interdisciplinaire
interesante	intéressant
interfaz	interface
interiores	intérieures
Interiores	intérieures
interior	intérieur
intermediarios	intermédiaires
interministerial	interministérielle
internacionales	internationales
internacional	international
internacional	internationale
interna	interne
internan	internés
internas	internes
internautas	internautes
interno	interne
internos	internes
interpretaciones	interprétations
interpretado	interprété
intérprete	interprète
intérpretes	interprètes
interprofesional	interprofessionnel
interrogatorios	interrogatoires
interrumpido	interrompue
interrumpidos	interrompus
interrupciones	interruptions
intervalos	intervalles
intervenciones	interventions
intestinal	intestinale
íntima	intime
íntimas	intimes
íntimo	intime
íntimos	intimes
intocables	intouchables
intravenosa	intraveineuse
intravenoso	intraveineuse
intrigas	intrigues
intrínseca	intrinsèque
intrínsecamente	intrinsèquement
intrínsecas	intrinsèques
intrínseco	intrinsèque
introducciones	introductions
introducción	l'introduction
intrusos	intrus
intuición	intuition
inundaciones	inondations
inundó	inondé
invasiones	invasions
invasiva	invasive
invasivas	invasives
invenciones	inventions
invención	invention
inventada	inventée
inventados	inventés
inventario	inventaire
inventarios	inventaires
inventores	inventeurs
inventor	inventeur
investida	investie
inviernos	hivers
invitaciones	invitations
invitación	invitation
invitado	invité
invitados	invités
involuntariamente	involontairement
inyecciones	injections
iraní	iranien
irlandesa	irlandaise
irlandesas	irlandaises
irlandeses	irlandais
irlandés	irlandais
ironía	ironie
irreductibles	irréductibles
irregularidades	irrégularités
irreprochable	irréprochable
irresistible	irrésistible
irresoluble	insoluble
irreversible	irréversible
islamista	islamiste
islamistas	islamistes
isótopos	isotopes
italiana	italienne
italianas	italiennes
italiano	italien
italianos	italiens
jalonan	jalonnent
jamón	jambon
japonesas	japonaises
japonés	japonais
jardineros	jardiniers
jardín	jardin
jesuita	jésuite
jesuitas	jésuites
jóvenes	jeunes
joyas	joyaux
judiciales	judiciaires
judicial	judiciaire
jueces	juges
juguetes	jouets
jungla	jungle
junta	junte
jurados	jurés
jurídicamente	juridiquement
jurisdicciones	juridictions
jurisdicción	juridiction
jurisprudencia	jurisprudence
jurista	juriste
juristas	juristes
Justicia	justice
justifican	justifient
justificar	justifier
juzgar	juger
kilómetro	kilomètre
kilómetros	kilomètres
kurda	kurde
kurdo	kurde
laboratorio	laboratoire
laboratorios	laboratoires
laguna	lacune
lagunas	lacunes
lanzaderas	lanceurs
lanzamiento	lancement
lanzamientos	lancements
Latina	latine
latín	latin
latinoamericano	latino-américain
laureles	lauriers
lecciones	leçons
lectores	lecteurs
lector	lecteur
lectura	lecture
lecturas	lectures
legalización	légalisation
legalmente	légalement
legible	lisible
legibles	lisibles
legiones	légions
legislaciones	législations
legislación	législation
legislador	législateur
legislativa	législative
legislativas	législatives
legislativo	législatif
legislativos	législatifs
legislatura	législature
legitimación	légitimation
legítimamente	légitimement
legitimar	légitimer
legítimas	légitimes
legitimidad	légitimité
legítimos	légitimes
leguminosas	légumineuses
lenguaje	langage
lenguajes	langages
lengua	langue
lenguas	langues
lenta	lente
lentamente	lentement
lentas	lentes
lentejas	lentilles
lentes	lentilles
lentitud	lenteur
leones	lions
leopardos	léopards
lesbiana	lesbienne
lesbianas	lesbiennes
leucemia	leucémie
libanesa	libanaise
libaneses	libanais
libanés	libanais
liberación	libération
liberalismo	libéralisme
liberalización	libéralisation
liberal	libéral
Liberal	libéral
liberal	libérale
liberar	libérer
libertades	libertés
Libertades	libertés
libras	livres
libremente	librement
libreros	libraires
libros	livres
licencia	licence
licencias	licences
liebres	lièvres
ligas	ligues
ligeramente	légèrement
ligeros	légers
limitaba	limitait
limitación	limitation
limitada	limitée
limitadas	limitées
limitado	limité
limitados	limités
limitar	limiter
límite	limite
límites	limites
lineales	linéaires
líneas	lignes
lingüista	linguiste
lingüistas	linguistes
líquida	liquide
liquidar	liquider
liquidez	liquidités
líquido	liquide
líquidos	liquides
lirismo	lyrisme
listadas	listées
lista	liste
listas	listes
literalmente	littéralement
literatura	littérature
litigios	litiges
litio	lithium
litro	litre
litros	litres
lituano	lituanien
lituanos	lituaniens
localización	localisation
localizadas	localisées
localizados	localisés
localmente	localement
locomotora	locomotive
locomotoras	locomotives
logísticas	logistiques
logísticos	logistiques
logotipos	logos
longitudes	longueurs
lotería	loterie
lúcida	lucide
lucidez	lucidité
lúcido	lucide
lucrativa	lucrative
lunar	lunaire
macabra	macabre
macedonia	macédonienne
macedonio	macédonien
maceración	macération
madre	mère
madres	mères
maduración	maturation
magia	magie
magistrado	magistrat
magistrados	magistrats
magistratura	magistrature
magnesio	magnésium
magnético	magnétique
magnéticos	magnétiques
magnetismo	magnétisme
majestad	majesté
maléfica	maléfique
malentendido	malentendu
malformaciones	malformations
malnutrición	malnutrition
maná	manne
mandarín	mandarin
mandato	mandat
mandatos	mandats
manifestaciones	manifestations
manifestación	manifestation
manifestante	manifestant
manifestantes	manifestants
manipulaciones	manipulations
manipulación	manipulation
manipular	manipuler
mantenimiento	maintien
manual	manuel
manufacturados	manufacturés
manufacturero	manufacturier
manuscrita	manuscrite
manuscritas	manuscrites
maoísta	maoïste
maquillaje	maquillage
maratón	marathon
marcial	martiale
marea	marée
mareas	marées
márgenes	marges
margen	marge
marginales	marginaux
mariana	mariale
marihuana	marijuana
marina	marine
marinas	marines
marino	marin
marionetas	marionnettes
marítima	maritime
marítimas	maritimes
marítimo	maritime
marítimos	maritimes
mártires	martyrs
mártir	martyr
marxismo	marxisme
marxista	marxiste
marxistas	marxistes
masacrar	massacrer
masacre	massacre
masacres	massacres
masaje	massage
masajes	massage
mascarada	mascarade
masculina	masculine
masculinos	masculins
masiva	massive
masivamente	massivement
masivos	massifs
máster	masters
matadores	matadors
materialismo	matérialisme
materialista	matérialiste
materna	maternelle
maternidad	maternité
matriculado	immatriculé
matriculados	immatriculés
matrimonial	matrimoniale
matriz	matrice
mausoleo	mausolée
mayoritaria	majoritaire
mayoritarios	majoritaires
mayúsculas	majuscules
meandros	méandres
mecanismo	mécanisme
mecanismos	mécanismes
mecanización	mécanisation
medallas	médailles
mediación	médiation
mediatización	médiatisation
medicamento	médicament
medicamentos	médicaments
médicos	médecins
medieval	médiévale
mediocres	médiocres
mediocridad	médiocrité
mediterránea	méditerranéenne
mediterráneas	méditerranéennes
mediterráneos	méditerranéens
membrana	membrane
memorables	mémorables
memorando	mémorandum
memorándum	mémorandum
menciones	mentions
mendicidad	mendicité
meningitis	méningite
mensaje	message
mensajero	messager
mensajeros	messagers
mensajes	messages
mensuales	mensuelles
mentalidades	mentalités
mentalidad	mentalité
mental	mentale
menta	menthe
mentido	menti
menús	menus
mercante	marchande
mercenarios	mercenaires
mercurio	mercure
méritos	mérites
metabolismo	métabolisme
metabolitos	métabolites
metal	métal
metalurgia	métallurgie
metamorfosis	métamorphose
metanol	méthanol
meteorología	météorologie
metodología	méthodologie
métodos	méthodes
métrico	métrique
metro	métro
metrópoli	métropole
metrópolis	métropoles
metropolitanas	métropolitaines
Metropolitano	métropolitain
metros	mètres
mexicana	mexicaine
mexicano	mexicain
mexicanos	mexicains
microbiana	microbienne
microbiano	microbienne
microbios	microbes
microcosmos	microcosme
micrófono	micro
microondas	micro-ondes
microscópicas	microscopiques
microscópico	microscopique
miembro	membre
miembros	membres
migración	migration
migrantes	migrants
migratoria	migratoire
migratorios	migratoires
miles	milliers
milicia	milice
milicianos	miliciens
milicias	milices
militancia	militantisme
militante	militant
militantes	militants
militares	militaires
militarmente	militairement
militar	militaire
millar	millier
millas	milles
millonario	millionnaire
millones	millions
millón	million
minas	mines
mineral	minérale
mineras	minières
minero	minier
mineros	miniers
minimalista	minimaliste
mínimas	minimales
Ministerial	ministérielle
ministerios	ministères
Ministro	ministre
ministros	ministres
Ministros	ministres
minoría	minorité
minorías	minorités
minoritaria	minoritaire
minoritarias	minoritaires
minoritarios	minoritaires
mintió	menti
minúsculas	minuscules
minuto	minute
minutos	minutes
miserable	misérable
miserables	misérables
miserias	misères
misiles	missiles
misil	missile
misioneros	missionnaires
misiones	missions
misión	mission
misteriosamente	mystérieusement
mitin	meeting
mixta	mixte
mixtas	mixtes
mixtos	mixtes
mobiliario	mobilier
mobiliarios	mobilières
modalidades	modalités
modelización	modélisation
modelos	modèles
moderación	modération
moderadamente	modérément
moderna	moderne
modernas	modernes
modernidad	modernité
modernización	modernisation
modernizado	modernisé
moderniza	modernise
modernizar	moderniser
moderno	moderne
modernos	modernes
modesta	modeste
modestia	modestie
modesto	modeste
modestos	modestes
modificaciones	modifications
modificación	modification
modificada	modifiée
modificadas	modifiées
modificado	modifié
modificados	modifiés
modifica	modifiant
modificar	modifier
modulación	modulation
módulo	module
módulos	modules
molde	moule
molécula	molécule
moleculares	moléculaires
moléculas	molécules
moluscos	mollusques
momia	momie
momias	momies
monarca	monarque
monasterio	monastère
monasterios	monastères
monetaria	monétaire
monetarias	monétaires
monje	moine
monjes	moines
monografías	monographies
monolito	monolithe
monólogo	monologue
monopolio	monopole
monopolios	monopoles
monótona	monotone
monstruo	monstre
monstruosa	monstrueuse
monstruos	monstres
monstruoso	monstrueux
montaña	montagne
monumentos	monuments
moralidad	moralité
moralista	moraliste
moralmente	moralement
moral	morale
moratoria	moratoire
morder	mordre
morfina	morphine
morirá	mourra
morir	mourir
mortalidad	mortalité
mortalmente	mortellement
mortero	mortier
mosqueteros	mousquetaires
mosto	moût
motivaciones	motivations
motivación	motivation
motivado	motivé
motivados	motivés
motivar	motiver
motores	moteurs
motorización	motorisation
motor	moteur
móviles	mobiles
movilización	mobilisation
movilizar	mobiliser
movimiento	mouvement
movimientos	mouvements
muebles	meubles
mueren	meurent
muertos	morts
multidisciplinario	multidisciplinaire
multidisciplinar	pluridisciplinaire
multilingüe	multilingue
multimedia	multimédia
multimedia	multimédias
multimedios	multimédia
multinacionales	multinationales
multinacional	multinationale
múltiples	multiples
multiplicación	multiplication
multiplicador	multiplicateur
multiplicados	multipliés
multiplica	multiplie
multiplican	multiplient
multiplicar	multiplier
multiplicidad	multiplicité
mundialización	mondialisation
Mundial	mondiale
mundos	mondes
municiones	munitions
municipios	municipalités
músculos	muscles
museo	musée
museos	musées
musulmana	musulmane
musulmanes	musulmans
musulmán	musulman
mutilaciones	mutilations
mutilado	mutilé
mutilados	mutilés
mutualidad	mutualité
mutuamente	mutuellement
mutuas	mutuelles
naciente	naissante
nacionales	nationales
nacionalidades	nationalités
nacionalidad	nationalité
nacionalismo	nationalisme
nacionalista	nationaliste
nacionalistas	nationalistes
nacionalización	nationalisation
nacional	national
nacionalsocialismo	national-socialisme
nacionalsocialista	national-socialiste
naciones	nations
nación	nation
nanopartículas	nanoparticules
napolitano	napolitain
narración	narration
narrador	narrateur
natación	natation
natalidad	natalité
naturales	naturelles
naturaleza	nature
naturalista	naturaliste
naturalización	naturalisation
naufragio	naufrage
naufragios	naufrages
náufragos	naufragés
navales	navals
naval	navale
navarro	navarrais
navegable	navigable
navegables	navigables
navegación	navigation
navegante	navigateur
nazismo	nazisme
necesariamente	nécessairement
necesarias	nécessaires
necesarios	nécessaires
néctar	nectar
neerlandés	néerlandais
negativas	négatives
negativo	négatif
negativos	négatifs
negligencia	négligence
negociaciones	négociations
negociación	négociation
negociadores	négociateurs
negociador	négociateur
negocia	négocie
negociar	négocier
neologismos	néologismes
netas	nettes
neumonía	pneumonie
neurológicas	neurologiques
neurológico	neurologique
neurológicos	neurologiques
neurólogo	neurologue
neutrales	neutres
neutralidad	neutralité
neutralización	neutralisation
neutral	neutre
nicho	niche
nigeriana	nigériane
nigeriano	nigérian
nitrato	nitrate
nitratos	nitrates
nivel	niveau
nobleza	noblesse
noción	notion
nocturna	nocturne
nómada	nomade
nómadas	nomades
nomenclatura	nomenclature
nominados	nominés
norcoreano	nord-coréen
noreste	nord-est
normalización	normalisation
noroeste	nord-ouest
norte-sur	nord-sud
nostalgia	nostalgie
notario	notaire
notarios	notaires
notas	notes
notificación	notification
novicios	novices
noviembre	novembre
nubes	nuages
nucleares	nucléaires
numerados	numérotés
nutrición	nutrition
objetivos	objectifs
oblicuo	oblique
oblicuos	obliques
obligaciones	obligations
obligatoriamente	obligatoirement
obligatoria	obligatoire
obligatorias	obligatoires
obligatorio	obligatoire
obligatorios	obligatoires
obreros	ouvriers
observadores	observateurs
observatorio	observatoire
observatorios	observatoires
obsoleta	obsolète
obsoletas	obsolètes
obsoletos	obsolètes
obstáculo	obstacle
obstáculos	obstacles
obtenidos	obtenus
ocasional	occasionnelle
occidentales	occidentaux
Occidentales	occidentaux
occidental	occidentale
Occidental	occidentale
océanos	océans
octubre	octobre
ocular	oculaire
ocupantes	occupants
oeste	l'ouest
ofensiva	offensive
ofensivos	offensifs
oficiales	officielles
oficialmente	officiellement
oficial	officielle
oficios	offices
ofrenda	offrande
ojivas	ogives
oliva	d'olive
olivos	oliviers
omnipresente	omniprésente
ontológico	ontologique
opciones	options
operaciones	opérations
operación	opération
óperas	opéras
operativo	opérationnel
operativos	opérationnels
oponentes	opposants
oportunista	opportuniste
oportunistas	opportunistes
oposición	l'opposition
oprimidos	opprimés
óptima	optimale
óptimas	optimales
optimista	optimiste
oralmente	oralement
oratoria	oratoire
órbita	orbite
ordene	ordonne
ordinario	ordinaire
organizaciones	organisations
organizadas	organisées
organizado	organisé
organizadores	organisateurs
organizador	organisateur
organizados	organisés
organolépticas	organoleptiques
órgano	organe
órganos	organes
orientaciones	orientations
oriental	orientale
orígenes	origines
ornamentales	ornementale
ornamental	ornementale
ornamental	ornementales
ortodoxa	orthodoxe
ortodoxas	orthodoxes
ortodoxo	orthodoxe
ortodoxos	orthodoxes
otomano	ottoman
Otomano	ottoman
ozono	d'ozone
paciencia	patience
paciente	patient
pacientes	patients
pacíficamente	pacifiquement
pacificar	pacifier
pacifismo	pacifisme
pacifista	pacifiste
pacto	pacte
padres	parents
padrino	parrain
paisaje	paysage
paisajes	paysages
paisajista	paysagiste
pakistaní	pakistanais
palacios	palais
palestina	palestinienne
palestinas	palestiniennes
palestino	palestinien
palma	palme
pandemia	pandémie
panes	pains
panoplia	panoplie
papás	papas
paquete	paquet
paquetes	paquets
parabrisas	pare-brise
paracaidistas	parachutistes
paradigma	paradigme
paradigmas	paradigmes
paradoja	paradoxe
paradójicamente	paradoxalement
paraguayo	paraguayen
paraíso	paradis
paraísos	paradis
paralelas	parallèles
paralelo	parallèle
paralelos	parallèles
parálisis	paralysie
parámetro	paramètre
parámetros	paramètres
paramilitares	paramilitaires
paramilitar	paramilitaire
paranoia	paranoïa
paranoica	paranoïaque
parásitos	parasites
parcialmente	partiellement
parentesco	parenté
pares	pairs
pariente	parent
parisina	parisienne
parisino	parisien
Paritaria	paritaire
parlamentaria	parlementaire
parlamentario	parlementaire
parlamentarios	parlementaires
parlamento	parlement
parlamentos	parlements
Parlamentos	parlements
parques	parcs
partes	parties
partición	partition
participaban	participaient
participación	participation
participantes	participants
participa	participe
participarán	participeront
participar	participer
participativa	participative
participativo	participatif
particularidades	particularités
particular	particulier
partículas	particules
partido	parti
Partido	parti
partidos	partis
partituras	partitions
pasajero	passager
pasajeros	passagers
pasaporte	passeport
pasaportes	passeports
pasarela	passerelle
pasiones	passions
pasión	passion
pasiva	passive
pasividad	passivité
pasivo	passif
pasivos	passifs
pastoral	pastorale
pastor	pasteur
paté	pâté
paternidad	paternité
patines	patins
patológicos	pathologiques
patria	patrie
patriarcal	patriarcale
Patriarca	patriarche
patrimonio	patrimoine
patriota	patriote
patriotas	patriotes
patrióticas	patriotiques
patrióticos	patriotiques
patriotismo	patriotisme
patronal	patronat
patrulla	patrouille
patrullas	patrouilles
pausa	pause
peajes	péages
peatones	piétons
pedagogía	pédagogie
penales	pénales
penal	pénal
penal	pénale
penas	peines
península	péninsule
pensaban	pensaient
pensador	penseur
pensiones	pensions
pensión	pension
peores	pires
percepción	perception
perder	perdre
perdidas	perdues
perdido	perdu
perdidos	perdus
peregrinos	pèlerins
perejil	persil
perennes	pérennes
perfila	profile
perfiles	profils
perfil	profil
perfume	parfum
permanentes	permanents
permiten	permettent
permite	permet
permitía	permettait
permitido	permis
permitirán	permettront
permitirá	permettra
permitir	permettre
perpetua	perpétuité
persecuciones	persécutions
perseverancia	persévérance
persistencia	persistance
personaje	personnage
personajes	personnages
personales	personnelles
personalidades	personnalités
personalidad	personnalité
personalización	personnalisation
personalizada	personnalisée
personalizados	personnalisés
personalizar	personnaliser
personalmente	personnellement
personal	personnel
persona	personne
personas	personnes
perspectiva	perspective
perspectivas	perspectives
persuadir	persuader
persuasión	persuasion
pertinencia	pertinence
perturbaciones	perturbations
perturbación	perturbation
perturba	perturbe
perturbar	perturber
perversión	perversion
perversos	pervers
pesimismo	pessimisme
pesimista	pessimiste
pesticidas	pesticides
petróleo	pétrole
petroleras	pétrolières
petrolero	pétrolier
petroleros	pétroliers
pianista	pianiste
piedra	pierre
piedras	pierres
pierden	perdent
pigmeos	pygmées
pilares	piliers
pilar	pilier
pilas	piles
piloto	pilote
pilotos	pilotes
pintó	peint
pintor	peintre
pintura	peinture
pinturas	peintures
pionero	pionnier
piquete	piquet
piragua	pirogue
pirámide	pyramide
pirámides	pyramides
piratas	pirates
piratería	piraterie
piscina	piscine
pista	piste
pistas	pistes
plácido	placide
planes	plans
planeta	planète
planetas	planètes
planificación	planification
planificada	planifiée
planifica	planifie
planificar	planifier
plantaciones	plantations
plantación	plantation
plantada	plantée
plantado	planté
plantados	plantés
plantas	plantes
plataforma	plate-forme
plataformas	plates-formes
platos	plats
playas	plages
plazas	places
plenipotenciario	plénipotentiaire
plomo	plomb
pluma	plume
plumas	plumes
pluralidad	pluralité
pluralismo	pluralisme
plusvalía	plus-value
plutonio	plutonium
poblaciones	populations
poemas	poèmes
poetas	poètes
poéticos	poétiques
póker	poker
polacos	polonais
polares	polaires
polarización	polarisation
polar	polaire
Polar	polaire
polar	polaires
polen	pollen
policial	policière
policía	police
poligamia	polygamie
polinización	pollinisation
polinizadores	pollinisateurs
políticamente	politiquement
politólogo	politologue
polivalente	polyvalente
pompa	pompe
ponderación	pondération
populares	populaires
popularidad	popularité
popularizado	popularisé
popular	populaire
Popular	populaire
populista	populiste
porcelana	porcelaine
porcentaje	pourcentage
porcentajes	pourcentages
porosidad	porosité
portaaviones	porte-avions
portales	portails
portal	portail
portátiles	portables
portuaria	portuaire
portuarias	portuaires
portuario	portuaire
portuarios	portuaires
portuguesa	portugaise
portuguesas	portugaises
portugueses	portugais
portugués	portugais
posibilidades	possibilités
posibilidad	possibilité
posible	possible
posiciones	positions
posición	position
positiva	positive
positivas	positives
positivo	positif
positivos	positifs
posmoderna	postmoderne
postales	postaux
postproducción	post-production
postulados	postulats
potasio	potassium
potenciales	potentiels
potencialidades	potentialités
potencialmente	potentiellement
potencial	potentiel
practicar	pratiquer
pragmática	pragmatique
pragmático	pragmatique
pragmatismo	pragmatisme
preámbulo	préambule
precauciones	précautions
precaución	précaution
precedente	précédent
precisamente	précisément
precisas	précises
precisiones	précisions
precisión	précision
precursores	précurseurs
precursor	précurseur
predicador	prédicateur
preeminencia	prééminence
prefecto	préfet
prefectos	préfets
preferencial	préférentiel
preferencia	préférence
preferencias	préférences
preferente	préférentiel
preferible	préférable
prefieren	préfèrent
prefiere	préfère
prefigura	préfigure
preliminares	préliminaires
preludio	prélude
prematuramente	prématurément
prematura	prématurée
prematuro	prématuré
prensa	presse
prensas	presses
preocupaciones	préoccupations
preparación	préparation
preparan	préparent
prepara	prépare
preparativos	préparatifs
preparatoria	préparatoire
preparatorias	préparatoires
preparatorio	préparatoire
preparatorios	préparatoires
prerrogativa	prérogative
prerrogativas	prérogatives
prescribe	prescrit
prescripción	prescription
presencia	présence
presentaciones	présentations
presentación	présentation
preservar	préserver
presidenciales	présidentielles
Presidencia	présidence
presidenta	présidente
presidentes	présidents
Presidentes	présidents
presidir	présider
presiones	pressions
presión	pression
prestaciones	prestations
prestigio	prestige
prestigiosa	prestigieuse
prestigioso	prestigieux
pretensiones	prétentions
pretexto	prétexte
prevención	prévention
prevenir	prévenir
preventiva	préventive
preventivas	préventives
previsible	prévisible
previsiones	prévisions
prima	prime
primarias	primaires
primario	primaire
primarios	primaires
primeros	premiers
primitivas	primitives
princesa	princesse
Princesa	princesse
princesas	princesses
príncipe	prince
príncipes	princes
principios	principes
prioridades	priorités
prioridad	priorité
prioritaria	prioritaire
prioritarias	prioritaires
prioritario	prioritaire
prioritarios	prioritaires
prisionero	prisonnier
prisioneros	prisonniers
prisiones	prisons
prisión	prison
privadas	privées
privado	privé
privados	privés
priva	prive
privar	priver
privatización	privatisation
privilegiada	privilégiée
privilegiadas	privilégiées
privilegiado	privilégié
privilegiados	privilégiés
privilegio	privilège
privilegios	privilèges
probablemente	probablement
problema	problème
problemas	problèmes
problemáticas	problématiques
procesión	procession
proceso	processus
proclamación	proclamation
proclamada	proclamée
proclamar	proclamer
procónsul	proconsul
procreación	procréation
prodigioso	prodigieux
producciones	productions
producir	produire
productiva	productive
productividad	productivité
productivo	productif
producto	produit
productoras	productrices
productores	producteurs
productor	producteur
productos	produits
profesionalidad	professionnalisme
profesionalización	professionnalisation
profesional	professionnelle
profesiones	professions
profesión	profession
profesor	professeur
Profesor	professeur
profundamente	profondément
profunda	profonde
profundas	profondes
profundidades	profondeurs
programaciones	programmations
programación	programmation
programada	programmée
programadores	programmeurs
programa	programme
programar	programmer
programas	programmes
progresista	progressiste
Progresista	progressiste
progresistas	progressistes
progresivamente	progressivement
progresiva	progressive
progresivo	progressif
progreso	progrès
Project	project
proliferación	prolifération
prolíficos	prolifiques
prólogo	prologue
prolongaciones	prolongements
prolongar	prolonger
promesa	promesse
promesas	promesses
prometedores	prometteurs
prometedor	prometteur
prometen	promettent
prometer	promettre
prometidas	promises
prometido	promis
prometió	promis
promociones	promotions
promoción	promotion
promotor	promoteur
promover	promouvoir
pronunciación	prononciation
propagación	propagation
propagan	propagent
propensión	propension
propias	propres
propietario	propriétaire
propietarios	propriétaires
propios	propres
propondrá	proposera
propone	propose
proponer	proposer
proporcionalidad	proportionnalité
proporcionalmente	proportionnellement
proporcional	proportionnelle
proporciones	proportions
propulsión	propulsion
proselitismo	prosélytisme
prospección	prospection
prospectiva	prospective
prospecto	prospectus
prosperar	prospérer
prósperas	prospères
próstata	prostate
prostitución	prostitution
prostituta	prostituée
prostitutas	prostituées
protagonistas	protagonistes
protecciones	protections
proteccionismo	protectionnisme
protección	protection
protectorado	protectorat
protectores	protecteurs
protector	protecteur
protegen	protègent
protege	protège
proteger	protéger
protegía	protégeait
protegidos	protégés
proteínas	protéines
protestado	protesté
protestan	protestent
protestantes	protestants
Protestantismo	protestantisme
protesta	protestation
protestar	protester
protestas	protestations
protesto	proteste
protocolo	protocole
Protocolo	protocole
protocolos	protocoles
prototipo	prototype
prototipos	prototypes
provenzal	provençale
provinciales	provinciaux
provincia	province
provincias	provinces
provisionales	provisoires
provisionalmente	provisoirement
provocaciones	provocations
provocación	provocation
provocador	provocateur
proximidad	proximité
proyección	projection
proyecto	projet
proyectos	projets
prusiano	prussien
psicología	psychologie
psicoterapia	psychothérapie
pubertad	puberté
publicaciones	publications
publicación	publication
publicado	publié
publicados	publiés
públicamente	publiquement
publicando	publiant
publicar	publier
publicidad	publicité
publicitarias	publicitaires
publicitario	publicitaire
público	public
publicó	publié
públicos	publics
pudor	pudeur
puentes	ponts
puertos	ports
pulmonares	pulmonaires
pulmonar	pulmonaire
pulmones	poumons
pulmón	poumon
pulverización	pulvérisation
punitiva	punitive
puntos	points
puramente	purement
puras	pures
pureza	pureté
purgas	purges
purgatorio	purgatoire
purificación	purification
quilla	quille
quimioterapia	chimiothérapie
quince	quinze
quirúrgicas	chirurgicales
quórum	quorum
rabinos	rabbins
racial	raciale
racionalización	rationalisation
racionamiento	rationnement
ración	ration
racismo	racisme
racista	raciste
racistas	racistes
radares	radars
radiactivas	radioactives
radiactividad	radioactivité
radiactivos	radioactifs
radicales	radicaux
radicalismo	radicalisme
radicalmente	radicalement
radiodifusión	radiodiffusion
radiológica	radiologique
radioterapia	radiothérapie
radón	radon
raíces	racines
ralentiza	ralentit
ralentizar	ralentir
ramificaciones	ramifications
rampante	rampant
rampa	rampe
rápidamente	rapidement
rápida	rapide
rápidas	rapides
rápidos	rapides
raras	rares
ratificación	ratification
ratificada	ratifiée
ratificado	ratifié
ratificar	ratifier
rayos	rayons
razonablemente	raisonnablement
razonable	raisonnable
razonables	raisonnables
razonamiento	raisonnement
razonamientos	raisonnements
razones	raisons
reaccionarios	réactionnaires
reacciones	réactions
reactiva	réactive
reactivos	réactifs
reactores	réacteurs
reactor	réacteur
reafirma	réaffirme
reafirmar	réaffirmer
realismo	réalisme
realista	réaliste
realistas	réalistes
rebeldes	rebelles
recarga	recharge
recesión	récession
reciclado	recyclage
reciclaje	recyclage
reciente	récente
recientes	récentes
recipientes	récipients
reciprocidad	réciprocité
reclutamiento	recrutement
reclutan	recrutent
reclutar	recruter
reclutas	recrues
recombinación	recombinaison
recomendaciones	recommandations
recomendación	recommandation
recomendadas	recommandées
recomendado	recommandé
recomendados	recommandés
recomendar	recommander
recomienda	recommande
recomiendo	recommande
recompensado	récompensé
recompensa	récompense
recompensar	récompenser
reconciliación	réconciliation
reconocible	reconnaissable
reconquista	reconquête
Reconquista	reconquista
reconquistar	reconquérir
reconstrucción	reconstruction
reconstruir	reconstruire
reconversión	reconversion
reconvertido	reconverti
récord	record
récords	records
recrear	recréer
recrudecimiento	recrudescence
rectángulo	rectangle
recurrentes	récurrents
recurso	recours
redactores	rédacteurs
redactor	rédacteur
redefinición	redéfinition
redescubrir	redécouvrir
redistribución	redistribution
redonda	ronde
redondas	rondes
reducciones	réductions
reducción	réduction
reescritura	réécriture
reestructuraciones	restructurations
reestructuración	restructuration
referencias	références
referendos	référendums
refinerías	raffineries
reflejan	reflètent
refleja	reflète
reflejar	refléter
reflexiones	réflexions
reflexión	réflexion
reflujos	reflux
reforma	réforme
reformas	réformes
reforzando	renforçant
refugiados	réfugiés
refugia	réfugie
refugiarse	réfugier
refugio	refuge
refundación	refondation
refutación	réfutation
refutar	réfuter
regente	régente
régimen	régime
regimientos	régiments
regionales	régionales
regionalista	régionaliste
regionalistas	régionalistes
regionalización	régionalisation
Regional	régional
regional	régionale
regiones	régions
región	région
registros	registres
reglamentarias	réglementaires
reglamentario	réglementaire
reglamento	règlement
reglamentos	règlements
regresión	régression
regularización	régularisation
regularmente	régulièrement
rehabilitación	réhabilitation
rehabilitado	réhabilité
rehabilitar	réhabiliter
reimpresión	réimpression
reinserción	réinsertion
reintegración	réintégration
reintroducción	réintroduction
reivindicaciones	revendications
reivindicación	revendication
relaciones	relations
relanzar	relancer
relativamente	relativement
relativista	relativiste
relieves	reliefs
religiones	religions
religión	religion
religiosas	religieuses
religioso	religieux
reliquia	relique
remolques	remorques
remonta	remonte
remuneración	rémunération
renace	renaît
renegar	renier
renovables	renouvelables
renovar	renouveler
rentabilidad	rentabilité
renunciar	renoncer
reorganización	réorganisation
reorganizar	réorganiser
reparaciones	réparations
reparación	réparation
reparar	réparer
reparto	répartition
repatriados	rapatriés
repertorio	répertoire
repertorios	répertoires
repliegue	repli
reportaje	reportage
reportajes	reportages
representaban	représentaient
representaciones	représentations
representación	représentation
representada	représentée
representadas	représentées
representado	représenté
representados	représentés
representan	représentent
representante	représentant
representar	représenter
representativa	représentative
representativas	représentatives
representatividad	représentativité
representativo	représentatif
representativos	représentatifs
represión	répression
reprimir	réprimer
reproducciones	reproductions
reproducción	reproduction
reptiles	reptile
Republicana	républicaine
republicano	républicain
republicanos	républicains
reputación	réputation
resentimiento	ressentiment
reservados	réservés
reservando	réservant
reserva	réserve
reservar	réserver
reservas	réserves
reservistas	réservistes
residenciales	résidentielles
residencial	résidentiel
residentes	résidents
residir	résider
residual	résiduel
resistencia	résistance
resistir	résister
resoluciones	résolutions
resolución	résolution
respectivamente	respectivement
respectivas	respectives
respetable	respectable
respetado	respecté
respeta	respecte
respetar	respecter
respeto	respect
respetuosa	respectueuse
respetuoso	respectueux
respirar	respirer
respiratoria	respiratoire
respiratorias	respiratoires
respiratorios	respiratoires
responderá	répondra
responde	répond
responder	répondre
responsabilidades	responsabilités
responsabilidad	responsabilité
restablecimiento	rétablissement
restauración	restauration
restaurante	restaurant
restaurantes	restaurants
restaurar	restaurer
restricciones	restrictions
restricción	restriction
restrictiva	restrictive
restringidas	restreintes
resucitar	ressusciter
resultado	résultat
resultados	résultats
resume	résume
resumir	résumer
reticencia	réticence
reticentes	réticents
retirada	retrait
retirar	retirer
retorno	retour
retornos	retours
retransmisión	retransmission
retrasos	retards
retrospectivamente	rétrospectivement
reunificación	réunification
reuniones	réunions
reutilización	réutilisation
reutilizar	réutiliser
reventa	revente
reverendo	révérend
reversible	réversible
revestimientos	revêtements
revisiones	révisions
revisión	révision
revolucionaria	révolutionnaire
revolucionarias	révolutionnaires
revolucionario	révolutionnaire
revolucionarios	révolutionnaires
revoluciones	révolutions
revolución	révolution
revólver	revolver
ricos	riches
ridículas	ridicules
ridículo	ridicule
ridículos	ridicules
rígida	rigide
rígidas	rigides
rigidez	rigidité
rígido	rigide
rígidos	rigides
rigor	rigueur
rigurosa	rigoureuse
rinoceronte	rhinocéros
riñones	reins
ritos	rites
rituales	rituels
ritual	rituel
rivalidades	rivalités
rivalidad	rivalité
robustos	robustes
rocas	rochers
rodamientos	roulements
rodante	roulant
romana	romaine
romanas	romaines
romano	romain
románticos	romantiques
rotaciones	rotations
rotación	rotation
rublos	roubles
rudimentaria	rudimentaire
rudimentaria	rudimentaires
rudimentos	rudiments
ruedas	roues
ruina	ruine
ruinas	ruines
ruleta	roulette
rumana	roumaine
rumanas	roumaines
rumano	roumain
rumanos	roumains
rumores	rumeurs
rumor	rumeur
ruptura	rupture
rupturas	ruptures
Rural	rural
rusas	russes
rusos	russes
rutina	routine
sabanas	savanes
sabotaje	sabotage
sacarosa	saccharose
sacrificado	sacrifié
sacrificar	sacrifier
sacrificios	sacrifices
salario	salaire
salarios	salaires
salas	salles
salinidad	salinité
salmones	saumons
salvajemente	sauvagement
salvaje	sauvage
salvajes	sauvages
sancionar	sanctionner
sancione	sanctionne
sanciones	sanctions
sanción	sanction
sanguinario	sanguinaire
sanguínea	sanguine
sanguíneo	sanguin
sanitarias	sanitaires
santos	saints
santuario	sanctuaire
sardina	sardine
sardinas	sardines
sargento	sergent
satélite	satellite
satélites	satellites
satisfecha	satisfaite
saturación	saturation
saturado	saturé
sauces	saules
Scout	scout
secciones	sections
sección	section
secesión	sécession
secretaría	secrétariat
secretas	secrètes
secreto	secret
secretos	secrets
sectarias	sectaires
sectarios	sectaires
sectas	sectes
sectores	secteurs
sector	secteur
secundaria	secondaire
secundarias	secondaires
secundario	secondaire
secundarios	secondaires
sedentaria	sédentaire
sedentario	sédentaire
sedentarios	sédentaires
sedimentos	sédiments
segmentación	segmentation
segmento	segment
segmentos	segments
selecciones	sélections
selectiva	sélective
selectivo	sélectif
semana	semaine
semanas	semaines
semen	sperme
seminarios	séminaires
sensibilidades	sensibilités
sensibilidad	sensibilité
sensibilización	sensibilisation
sensibilizar	sensibiliser
sentimientos	sentiments
separación	séparation
separar	séparer
separatista	séparatiste
separatistas	séparatistes
septentrional	septentrionale
septiembre	septembre
serbia	serbe
serbias	serbes
serbio	serbe
sereno	serein
sería	serait
series	séries
serpiente	serpent
serpientes	serpents
servicio	service
servicios	services
servidumbre	servitude
sesiones	session
sexos	sexes
sexuales	sexuels
sexualidad	sexualité
sexualmente	sexuellement
sexual	sexuelle
sharia	charia
sheriff	shérif
siderurgia	sidérurgie
sigla	sigle
signatario	signataire
signatarios	signataires
significa	signifie
signos	signes
silenciosa	silencieuse
silencio	silence
sílice	silice
silicona	silicone
siluetas	silhouettes
silvicultura	sylviculture
simbiosis	symbiose
símbolos	symboles
símbolo	symbole
similares	similaires
simpatizantes	sympathisants
simplemente	simplement
simplicidad	simplicité
simplificación	simplification
simplificado	simplifié
simplificado	simplifiée
simplificados	simplifiées
simplificar	simplifier
simplifica	simplifie
simplista	simpliste
simposio	symposium
simulaciones	simulations
simulación	simulation
simulacros	simulations
simulador	simulateur
simultánea	simultanée
simultáneo	simultané
sinagogas	synagogues
sinagoga	synagogue
sincronización	synchronisation
sindicalismo	syndicalisme
sindicalista	syndicaliste
sindical	syndical
sindical	syndicale
sindicatos	syndicats
sindicato	syndicat
síndromes	syndromes
síndrome	syndrome
sinergias	synergies
sinergia	synergie
singularidades	singularités
siniestro	sinistre
sionismo	sionisme
sionista	sioniste
sionistas	sionistes
sirenas	sirènes
sitios	sites
situaciones	situations
situación	situation
situados	situés
soberanas	souveraines
soberano	souverain
soberanos	souverains
sobreexplotación	surexploitation
socialdemócrata	social-démocrate
socialdemócratas	sociaux-démocrates
socialismo	socialisme
socialista	socialiste
Socialista	socialiste
socialistas	socialistes
Socialistas	socialistes
socialización	socialisation
socialmente	socialement
social	sociale
socioeconómicas	socio-économiques
socioeconómicos	socio-économiques
sociología	sociologie
sociológica	sociologique
sociológicas	sociologiques
sociológico	sociologique
sociológicos	sociologiques
sociólogo	sociologue
sociólogos	sociologues
sodio	sodium
solares	solaires
solar	solaire
soldado	soldat
soldados	soldats
solemnemente	solennellement
solemne	solennelle
solidaria	solidaire
solidaridad	solidarité
solidario	solidaire
sólidos	solides
solitaria	solitaire
solsticio	solstice
soluciones	solutions
solución	solution
sondas	sondes
sondeos	sondages
sonorización	sonorisation
soportar	supporter
sorgo	sorgho
soviéticas	soviétiques
soviético	soviétique
soviéticos	soviétiques
Stand	stand
subcontinente	sous-continent
subdivisiones	subdivisions
subjetiva	subjective
subjetividad	subjectivité
subjetivo	subjectif
subjuntivo	subjonctif
submarino	sous-marin
submarinos	sous-marins
subordinación	subordination
subordinados	subordonnés
subsistencia	subsistance
subterráneas	souterraines
suburbano	suburbain
subvenciones	subventions
subversión	subversion
sucesiones	successions
sucesión	succession
sucesivas	successives
sucesivos	successifs
sucesores	successeurs
sucesor	successeur
sucursal	succursale
sudafricano	sud-africain
sudamericano	sud-américain
sudanés	soudanais
sudeste	sud-est
sudoeste	sud-ouest
sufragio	suffrage
sugiere	suggère
suicida	suicidaire
suicidios	suicides
suicidio	suicide
suicidó	suicidé
sulfato	sulfate
superestrella	superstar
superestructura	superstructure
superficies	surfaces
superficie	surface
superioridad	supériorité
superior	supérieur
supermercados	supermarchés
supermercado	supermarché
superstición	superstition
supervivientes	survivants
superviviente	survivant
suplantar	supplanter
suplentes	suppléants
suplente	suppléant
supresión	suppression
suprimir	supprimer
surrealista	surréaliste
suscripción	souscription
suspender	suspendre
suspendido	suspendu
suspensión	suspension
sustancias	substances
sustancia	substance
sutiles	subtiles
sutil	subtile
tabaco	tabac
tabaquismo	tabagisme
tablas	tableaux
tableta	tablette
tacones	talons
tailandés	thaïlandais
talentos	talents
talento	talent
talibanes	talibans
talismán	talisman
tallas	tailles
talón	talon
tándem	tandem
tarificación	tarification
tatuaje	tatouage
teatrales	théâtrales
tecnologías	technologies
tecnología	technologie
tecnológicas	technologiques
tecnológicos	technologiques
tecno	techno
tejano	texan
telecomunicaciones	télécommunications
televisiones	télévisions
temblar	trembler
temperamento	tempérament
temperaturas	températures
temperatura	température
templo	temple
temporales	temporaires
temporalmente	temporairement
temporal	temporaire
tendencias	tendances
tendencia	tendance
tenis	tennis
tenores	ténors
tensiones	tensions
tensión	tension
tentaciones	tentations
tentación	tentation
tentáculos	tentacules
tentados	tentés
terapias	thérapies
termal	thermale
terminales	terminaux
terminología	terminologie
territorial	territoriale
territorios	territoires
territorio	territoire
terrorismo	terrorisme
terroristas	terroristes
terrorista	terroriste
terror	terreur
tesorero	trésorier
tesoros	trésors
testamentos	testaments
testamento	testament
textil	textile
textos	textes
texto	texte
textual	textuelle
tibetana	tibétaine
tibetano	tibétain
tiempo	temps
tierras	terres
tiranos	tyrans
tirano	tyran
titulares	titulaires
tolerancia	tolérance
tolerar	tolérer
tomate	tomates
tormentos	tourments
tornado	tornade
torrenciales	torrentielles
torrentes	torrents
torrente	torrent
torsión	torsion
tortugas	tortues
tortuga	tortue
torturados	torturés
torturado	torturé
torturar	torturer
tortura	torture
totalitario	totalitaire
toxicidad	toxicité
toxinas	toxines
toxina	toxine
tractores	tracteurs
tractor	tracteur
tradicionales	traditionnelles
tradicionales	traditionnels
tradicionalmente	traditionnellement
tradicional	traditionnelle
tradiciones	traditions
tradición	tradition
traducciones	traductions
traducción	traduction
traductor	traducteur
traficantes	trafiquants
tráfico	trafic
tragedias	tragédies
tragedia	tragédie
traidores	traîtres
trampolín	tremplin
transacciones	transactions
transatlánticas	transatlantiques
transatlántica	transatlantique
transatlántico	transatlantique
transcripción	transcription
transferencias	transferts
transferencia	transfert
transferido	transféré
transferir	transférer
transformación	transformation
transformadores	transformateurs
transformados	transformés
transforman	transforment
transformará	transformera
transformar	transformer
transfronteriza	transfrontalière
transfronterizo	transfrontalier
transiciones	transitions
transición	transition
transitorias	transitoires
transitorio	transitoire
tránsito	transit
transparencia	transparence
transplantes	transplantation
transplante	transplantation
transportadas	transportées
transportada	transportée
transportados	transportés
transportado	transporté
transportistas	transporteurs
transportista	transporteur
transposición	transposition
transversal	transversale
tratamientos	traitements
tratamiento	traitement
traumas	traumatismes
trauma	traumatisme
travesías	traversées
trazabilidad	traçabilité
trece	treize
triangulares	triangulaires
triangular	triangulaire
triángulo	triangle
tribal	tribale
tribunales	tribunaux
tribuna	tribune
trilingüe	trilingue
trilogía	trilogie
trimestralmente	trimestriel
trimestral	trimestriel
tripartita	tripartite
tristeza	tristesse
tritio	tritium
triunvirato	triumvirat
tropas	troupes
tropical	tropicale
trotskista	trotskiste
trufas	truffes
tuberculosis	tuberculose
tumores	tumeurs
tumor	tumeur
túneles	tunnels
túnel	tunnel
tungsteno	tungstène
turba	tourbe
turbinas	turbines
turbulencias	turbulences
turismo	tourisme
turistas	touristes
turista	touriste
tutelar	tutélaire
tutela	tutelle
tutsi	tutsis
ultimátum	ultimatum
unánime	unanime
unilateralmente	unilatéralement
unilateral	unilatérale
unitaria	unitaire
universales	universels
universalmente	universellement
universal	universel
Universal	universelle
universidades	universités
universidad	l'université
universidad	université
universitaria	universitaire
universitarios	universitaires
universitario	universitaire
urbanas	urbaines
urbana	urbaine
urbanismo	l'urbanisme
urbanización	l'urbanisation
urbanos	urbains
urbano	urbain
urgencias	urgences
urnas	urnes
utensilios	ustensiles
útiles	utiles
utilitarista	utilitaire
utilizables	utilisables
utilizable	utilisable
vacantes	vacants
vacante	vacant
vacas	vaches
vacunas	vaccins
vagones	wagons
vainilla	vanille
valer	valoir
validación	validation
validar	valider
valles	vallées
valle	vallée
Valle	vallée
valores	valeurs
valorización	valorisation
valorizar	valoriser
valoriza	valorise
valor	valeur
vandalismo	vandalisme
vapores	vapeurs
vapor	vapeur
variabilidad	variabilité
variados	variés
variar	varier
vasculares	vasculaires
vectores	vecteurs
vector	vecteur
vegetales	végétales
veinte	vingt
vendedores	vendeurs
vendedor	vendeur
venderá	vendra
vender	vendre
vendía	vendait
vendidos	vendus
venganza	vengeance
vengarse	venger
ventas	ventes
venta	vente
verbal	verbale
verbo	verbe
veredicto	verdict
verificación	vérification
verificando	vérifiant
versiones	versions
versión	version
verticales	verticaux
verticalmente	verticalement
vertical	verticale
vestigio	vestige
veteranos	vétérans
viabilidad	viabilité
vibraciones	vibrations
vibrar	vibrer
Viceministro	vice-ministre
Vicepresidenta	vice-présidente
vicepresidentes	vice-présidents
Vicepresidentes	vice-présidents
Vicepresidente	vice-président
viceversa	versa
vicisitudes	vicissitudes
víctimas	victimes
víctima	victime
victoriana	victorienne
victoriano	victorienne
victorias	victoires
victoria	victoire
vietnamita	vietnamien
vinagre	vinaigre
vinificación	vinification
violaciones	violations
violación	violation
violencia	violence
violentamente	violemment
violentas	violentes
violenta	violente
violento	violent
viral	virale
virtuales	virtuelles
virtuales	virtuels
virtudes	vertus
virtuosismo	virtuosité
virulenta	virulente
visados	visas
visibilidad	visibilité
visionario	visionnaire
visión	vision
visitantes	visiteurs
visitante	visiteur
visitas	visites
visita	visite
vitalidad	vitalité
vitaminas	vitamines
viticultores	viticulteurs
viticultura	viticulture
vivacidad	vivacité
viven	vivent
víveres	vivres
vivero	vivier
vivimos	vivons
vivir	vivre
vocabulario	vocabulaire
vocaciones	vocations
vocación	vocation
vocal	vocale
volante	volant
volátiles	volatils
volatilidad	volatilité
volcanes	volcans
volcán	volcan
volúmenes	volumes
volumen	volume
voluntariamente	volontairement
voluntarias	volontaires
voluntaria	volontaire
voluntarios	volontaires
voluntario	volontaire
votar	voter
vulgares	vulgaires
vulgar	vulgaire
vulnerables	vulnérables
vulnerable	vulnérable
yates	yachts
yuanes	yuans
yuxtaposición	juxtaposition
zombis	zombies
zonas	zones
