abandon	abandon
abandonarea	abandon
abandonată	abandonnée
abandonat	abandonné
abandonate	abandonnées
abandonează	abandonnent
abandoneze	abandonner
abătut	abattue
abolită	abolie
abolit	aboli
abonament	abonnés
abonamente	abonnements
abrogat	abrogé
absența	absence
absentă	absente
absente	absentes
absoarbe	absorbe
absolută	absolue
absolut	absolument
absorb	absorbent
absorbi	absorber
absorbită	absorbe
absorbit	absorbé
absorbție	absorption
abstractă	abstraite
abstract	abstrait
abstracte	abstraites
absurdă	absurde
absurd	absurde
absurde	absurdes
abundentă	abondant
abundente	abondantes
abuziv	abusif
academică	académique
academic	académique
academice	académiques
academie	académie
academii	académies
accelera	accélérer
accelerarea	accélérer
accelerat	accéléré
accelerează	accélère
accent	accent
accentul	accent
acceptă	accepte
accepta	accepter
acceptabilă	acceptable
acceptabil	acceptable
acceptabile	acceptables
acceptând	acceptant
acceptarea	acceptant
acceptare	acceptation
acceptată	acceptée
acceptat	accepté
acceptate	acceptées
accepte	accepter
acces	accès
accesibilă	accessible
accesibil	accessible
accesibile	accessibles
accesibilitate	accessibilité
accesorii	accessoires
accesul	accès
accident	accident
accidentală	accidentelle
accidental	accidentel
accidente	accidents
accidentele	accidents
accidentul	accident
acide	acides
acopere	couvre
acoperirea	couverture
acoperire	couverture
acoperită	couverte
acoperit	couvert
acoperite	couvertes
acord	accord
acordul	accord
acorduri	accords
acordurile	accords
acreditat	accrédité
acționar	actionnaire
acționarii	actionnaires
acțiune	action
acțiuni	action
activă	active
activ	actif
activare	activation
activat	activé
active	actives
activeze	activer
activi	actifs
activist	activiste
activiștilor	activistes
activitate	activité
activități	activités
activitățile	activités
actor	acteur
actori	acteurs
actrițe	actrice
actuală	actuel
actuala	actuelle
actual	actuel
actuale	actuelle
actualei	actuelle
actualele	actuelles
actualitate	actualité
acumulare	accumulation
acumulat	accumulé
acumulate	accumulée
acumulează	accumule
adapta	adapter
adaptarea	adapter
adaptare	adaptation
adaptată	adaptée
adaptat	adapté
adapteze	adapter
adera	adhérer
adere	adhérer
adjectiv	adjectif
administrarea	administration
administrare	administration
administrat	administré
administrate	administrées
administrația	administration
administrație	administration
administrației	administration
administrativă	administrative
administrativ	administratif
administrative	administratives
administratori	administrateurs
admirat	admiré
admirație	admiration
admise	admises
admisie	admission
admite	admet
adolescenței	adolescence
adolescenții	adolescents
adoptă	adopte
adopta	adopter
adoptată	adoptée
adoptat	adopté
adoptate	adoptées
adopte	adopter
adopție	adoption
adriatică	adriatique
adultă	adulte
adulter	adultère
adulți	adultes
adversar	adversaire
adversarii	adversaires
adversarul	adversaire
aerian	aérien
aeriene	aériennes
aeronautică	aéronautique
aeroport	aéroport
aeroportul	aéroport
aeroportului	aéroport
aeroporturi	aéroports
aeroporturile	aéroports
aeroporturilor	aéroports
afiliate	affiliées
afinitate	affinité
afirmă	affirme
afirma	affirmer
afirmație	affirmation
afluenți	affluents
afluenții	affluents
africană	africaine
african	africain
africane	africains
agenți	agents
agenție	agence
agenții	agence
agențiile	agences
agentul	agent
agitat	agité
agravat	aggravé
agresiunea	agression
agresiune	agression
agresiuni	agressions
agresiunii	agression
agresivă	agressive
agresiv	agressive
agresive	agressive
agresivi	agressifs
agresivitatea	agressivité
agresivitate	agressivité
agricolă	agricole
agricol	agricole
agricole	agricoles
agricultori	agriculteurs
agricultorilor	agriculteurs
agricultura	agriculture
agricultură	agriculture
alarmă	alarme
albaneză	albanaise
albanez	albanaise
albaneze	albanaise
albanezi	albanais
alcool	alcool
alcoolice	alcoolisées
alcoolul	alcool
alertă	alerte
algebrică	algébrique
algele	algues
algerian	algérien
algoritm	algorithme
alianțe	alliances
aliat	allié
aliate	alliées
alimentară	alimentaire
alimentar	alimentaire
alimentare	alimentaire
alimentată	alimentée
alimentat	alimenté
alimentate	alimentés
alimentație	alimentation
alimente	aliments
alimentează	alimente
alimentele	aliments
alimentelor	aliments
alpină	alpine
alpine	alpines
alternativa	alternative
alternativă	alternative
alternative	alternatives
aluminiu	aluminium
aluviuni	alluvions
amară	amère
amator	amateur
amatori	amateur
ambasada	ambassade
ambasade	ambassades
ambasador	ambassadeur
ambasadori	ambassadeurs
ambasadorii	ambassadeurs
ambasadorilor	ambassadeurs
ambasadorul	ambassadeur
ambasadorului	ambassadeur
ambiguu	ambigu
ambiția	ambition
ambiție	ambition
ambițioasă	ambitieuse
ambițioase	ambitieuse
ambițios	ambitieux
amendament	amendement
amendamente	amendements
americană	américain
american	américain
americane	américaine
amfibii	amphibies
amnistie	amnistie
amprenta	empreinte
amprentă	empreinte
amprente	empreinte
analist	analyste
analiști	analystes
analitice	analytiques
analize	analyse
anarhie	anarchie
ancestrale	ancestrales
ancorat	ancré
anglo-saxone	anglo-saxonnes
animală	animale
animale	animaux
animalele	animaux
animalelor	animal
animalul	animal
animată	animé
animate	animés
aniversarea	anniversaire
aniversare	anniversaire
aniversării	anniversaire
anomalii	anomalies
anonimă	anonyme
anonime	anonymes
anormală	anormale
antenele	antennes
antibiotice	antibiotiques
antică	antique
anticipând	anticipant
anticipat	anticipé
anticomunistă	anticommuniste
anticomunist	anticommuniste
anticomuniste	anticommuniste
antidot	antidote
antisemit	antisémite
antisemitism	antisémitisme
antisemitismului	antisémitisme
antrenament	entraînement
anual	annuel
anuar	annuaire
anula	annuler
anulată	annulé
anulat	annulé
anuleze	annuler
aparatul	appareil
aparenta	apparent
aparentă	apparent
aparent	apparemment
aparente	apparentes
apartament	appartement
apartenență	appartenance
aparținea	appartenait
aparține	appartient
apelul	appel
apeluri	appels
aplicabilă	applicable
aplicabile	applicables
aplicații	applications
aplicațiile	applications
aplicațiilor	applications
aplice	appliquer
apreciat	apprécié
apreciază	apprécie
aprecieze	apprécier
aprobare	approbation
aprobe	approuver
aprofundarea	approfondir
aprofundat	approfondi
aprofundate	approfondies
aprovizionarea	approvisionnement
aprovizionare	approvisionnement
aproximativă	approximative
arabă	arabe
arabe	arabes
arbitraj	arbitrage
arbitrară	arbitraire
arbitrar	arbitraire
arbitrare	arbitraire
arbitrii	arbitres
arbitru	arbitre
arbitrul	arbitre
arctică	arctique
arctic	arctique
arctice	arctique
arenă	arène
arestarea	arrestation
arestări	arrestations
arestării	arrestation
argentiniană	argentine
argentinian	argentin
argentiniene	argentines
argumente	arguments
arhaice	archaïque
arheologică	archéologique
arheologic	archéologique
arheologice	archéologiques
arhipelag	archipel
arhipelagul	archipel
arhitect	architecte
arhitectonice	architecturale
arhitectura	architecture
arhitectură	architecture
arhitecturi	architecture
arhitecturii	architecture
arhivă	archive
arhive	archives
arhivele	archives
arhivelor	archives
aritmetică	arithmétique
armament	armement
armat	armé
armate	armées
armenii	arménienne
armenilor	arménien
armonia	harmonie
armonie	harmonie
armoniei	harmonie
armonios	harmonieuse
arogant	arrogant
aromatice	aromatiques
arsenal	arsenal
arsenalul	arsenal
artă	art
arterele	artères
arterială	artérielle
articol	article
articole	articles
articolele	articles
articolelor	articles
articolul	article
articolului	article
articulate	articulés
artificială	artificiel
artificial	artificiel
artificiale	artificielle
artilerie	artillerie
artileriei	artillerie
artist	artiste
artiști	artistes
artistică	artistique
artistic	artistique
artistice	artistique
artiștii	artistes
artistul	artiste
artizanale	artisanales
artizanat	artisanat
asamblate	assembler
asasinarea	assassinat
asasinare	assassiner
asasin	assassin
asasinat	assassinat
asasini	assassins
asasinii	assassins
asiatică	asiatique
asiatic	asiatique
asiatice	asiatique
asigurând	assurant
asigurare	assurance
asimetric	asymétrique
asimetrice	asymétriques
asimilare	assimilation
asimilat	assimilé
asirieni	assyriens
asistă	assiste
asista	assister
asistat	assisté
asistență	assistance
asistenta	assistant
asistent	assistant
asistentul	assistant
asociată	associé
asociat	associé
asociate	associées
asociație	association
asociații	associations
asociațiile	associations
asociațiilor	associations
asociază	associent
asocierea	association
aspecte	aspects
aspectele	aspects
aspiră	aspire
aspirația	aspiration
aspirație	aspiration
aspirații	aspirations
aspirațiile	aspirations
astronaut	astronaute
astronomică	astronomique
astronomice	astronomiques
asumă	assume
asuma	assumer
asume	assumer
atacurile	attaques
atentă	attentive
atenție	attention
atenuarea	atténuer
atlantică	atlantique
atlantice	atlantique
atmosfera	atmosphère
atmosferă	atmosphère
atmosferei	atmosphère
atmosferice	atmosphérique
atomică	atomique
atomice	atomiques
atractiv	attractif
atrage	attire
atribuită	attribuée
atribuite	attribuées
atribut	attribut
atribute	attributs
atributele	attributs
atributul	attribut
atrocități	atrocités
atrocitățile	atrocités
audiență	audience
auspiciile	auspices
australian	australien
australiene	australiennes
austriac	autrichien
austriece	autrichiens
austrieci	autrichiens
austro-ungară	austro-hongroise
austro-ungare	austro-hongroise
autentic	authentique
autenticitatea	authenticité
autoare	auteure
autobuzul	autobus
autocamioane	camions
autohtonă	autochtone
autohtone	autochtones
automată	automatique
automat	automatique
automobile	automobiles
automobilelor	automobile
autonomă	autonome
autonom	autonome
autonome	autonomes
autonomia	autonomie
autonomie	autonomie
autonomiei	autonomie
autor	auteur
autoritară	autoritaire
autoritar	autoritaire
autoritatea	autorité
autoritate	autorité
autorității	autorité
autoritățile	autorités
autorităților	autorités
autorizarea	autorisation
autorizată	autorisée
autorizat	autorisé
autorizate	autorisées
autorizează	autorise
autovehicule	véhicules
auxiliară	auxiliaire
auxiliare	auxiliaires
avangarda	avant-garde
avanpost	avant-poste
avansat	avancé
avansate	avancés
avantaj	avantage
avantaje	avantages
avantajoasă	avantageuse
avantajos	avantageux
aventură	aventure
aventurile	aventures
avertisment	avertissement
avocați	avocats
avocaților	avocats
avocatului	avocat
bacteria	bactérie
bacterie	bactérie
bacteriene	bactérienne
bacterii	bactérie
bacteriile	bactérie
bacteriilor	bactéries
bagajele	bagages
balene	baleine
balistice	balistiques
baltice	baltes
banal	banale
bancară	bancaire
bancar	bancaire
bancare	bancaire
bancher	banquier
banchet	banquet
bandă	bande
barbar	barbare
barbare	barbares
bariere	barrières
barierele	barrières
baronilor	barons
baterii	batteries
bateriile	batteries
bateriilor	batteries
bavarez	bavarois
bazinul	bassin
belarus	biélorusse
belgiană	belge
belgian	belge
belgiene	belge
belgieni	belges
beneficia	bénéficier
beneficiar	bénéficiaire
beneficiat	bénéficié
beneficieze	bénéficier
beneficiile	bénéfices
beneficiu	bénéfice
biblia	bible
biblic	biblique
biblice	bibliques
bibliotecă	bibliothèque
biblioteci	bibliothèque
bibliotecii	bibliothèque
bibliotecile	bibliothèques
bibliotecilor	bibliothèques
bicicletă	bicyclette
biciclete	bicyclettes
bilaterală	bilatérale
bilaterale	bilatérales
bilete	billets
biletele	billets
bilingvă	bilingue
bilingv	bilingue
bilingve	bilingue
biochimice	biochimiques
biodiversitate	biodiversité
biodiversității	biodiversité
biografii	biographies
biologică	biologique
biologic	biologique
biologice	biologique
biosferei	biosphère
biotehnologie	biotechnologies
birocrației	bureaucratie
bizare	bizarre
blocarea	blocage
blocuri	blocs
boicot	boycott
bombă	bombe
bombardament	bombardement
bombardamente	bombardements
bombardamentelor	bombardements
bombardarea	bombardement
bombardată	bombardé
bombardat	bombardé
bombele	bombes
bosniacă	bosniaque
bovine	bovins
bovinelor	bovins
brazilian	brésilien
brevete	brevets
brevetul	brevet
brigada	brigade
britanică	britannique
britanic	britannique
britanice	britanniques
britanici	britanniques
brută	brute
brutală	brutal
brutal	brutalement
brutalitate	brutalité
budismului	bouddhisme
budistă	bouddhiste
budist	bouddhiste
bulgară	bulgare
bulgar	bulgare
bulgare	bulgares
burgheze	bourgeois
burghezia	bourgeoisie
burgheziei	bourgeoisie
bursă	bourse
burse	bourses
bustul	buste
cabină	cabine
cabinetul	cabinet
cabinetului	cabinet
cadastru	cadastre
cadavre	cadavres
cafea	café
calcula	calculer
calcularea	calculer
calculată	calculée
calculat	calculé
calculate	calculées
calculează	calcule
calcule	calculs
calculele	calculs
calculelor	calculs
calculul	calcul
caldă	chaud
calendar	calendrier
calendare	calendriers
calendarul	calendrier
calendarului	calendrier
calibru	calibre
calificare	qualification
calificate	qualifiée
calitativă	qualitative
calitative	qualitative
calitativ	qualitatif
calmă	calme
calmul	calme
camerele	chambres
camioane	camions
campania	campagne
campanie	campagne
campaniei	campagne
campanii	campagne
campaniile	campagnes
campaniilor	campagnes
campioană	championne
campionatele	championnats
campionatul	championnat
campionii	champions
campionul	champion
campusul	campus
canadiană	canadienne
canadian	canadien
canadiene	canadien
canadieni	canadiens
canale	canaux
canalizarea	canalisation
canalul	canal
cancelar	chancelier
cancelarul	chancelier
cancelarului	chancelier
cancer	cancers
cancerul	cancer
cancerului	cancer
candidate	candidats
candidați	candidats
candidatul	candidat
candidatului	candidat
candidaturii	candidature
canonică	canon
canonic	canonique
canonice	canon
cantitativă	quantitative
cantitative	quantitative
cantitativ	quantitative
cantonul	canton
capabil	capable
capabile	capables
capabili	capables
capacitatea	capacité
capacitate	capacité
capacității	capacité
capitala	capitale
capitală	capitale
capital	capitaux
capitale	capitales
capitalele	capitales
capitalism	capitalisme
capitalismul	capitalisme
capitalismului	capitalisme
capitalistă	capitaliste
capitalist	capitaliste
capitaliste	capitalistes
capitalului	capital
căpitan	capitaine
căpitanul	capitaine
căpitanului	capitaine
capitol	chapitre
capitole	chapitres
capitolele	chapitres
capitolul	chapitre
capitulare	capitulation
captarea	captage
captivitate	captivité
captură	capture
capturarea	capture
capturat	capturé
captureze	capturer
caracteristică	caractéristique
caracteristici	caractéristiques
caracteristicile	caractéristiques
caracteristicilor	caractéristiques
caracterizată	caractérise
caracterizat	caractérise
caracterizate	caractérisent
caracterizează	caractérise
caracterul	caractère
carantină	quarantaine
carbon	carbone
carcasa	carcasses
cardiacă	cardiaque
cardiac	cardiaque
cardiace	cardiaques
caricatură	caricature
cariere	carrière
carierei	carrière
caritate	caritatives
cartezian	cartésien
cartierele	quartiers
cartierelor	quartiers
cartiere	quartiers
cartier	quartier
carul	charrue
castă	caste
catalana	catalan
catalană	catalan
catalane	catalan
catalog	catalogue
catalogul	catalogue
catastrofă	catastrophe
catastrofală	catastrophique
catedrala	cathédrale
catedralei	cathédrale
categorie	catégorie
categorii	catégorie
categoriile	catégories
categoriilor	catégories
catolică	catholique
catolic	catholique
catolice	catholique
catolici	catholiques
catolicii	catholiques
catolicismul	catholicisme
cauza	cause
cauze	causes
cauzele	causes
cazinou	casino
cehoslovac	tchécoslovaque
celtic	celtique
celula	cellule
celulă	cellule
celule	cellules
celulele	cellules
celulelor	cellules
centenarul	centenaire
centrală	centrale
centrale	centrales
centralele	centrales
centralizată	centralisée
centralizat	centralisé
centralizate	centralisée
centrată	centrée
centre	centres
centrele	centres
centrelor	centres
centru	centre
centru-dreapta	centre-droit
centrul	centre
centurile	ceintures
cenzura	censure
cenzură	censure
cenzurat	censuré
cenzurii	censure
cercetător	chercheur
cercul	cercle
cereale	céréales
cerealele	céréales
cerebrală	cérébral
cerebrale	cérébrales
ceremonia	cérémonie
ceremonie	cérémonie
certificarea	certification
certificare	certification
certificat	certificats
certificate	certificats
certificatul	certificat
certitudinea	certitude
chilian	chilien
chimică	chimique
chimic	chimique
chimice	chimiques
chimiei	chimie
chimist	chimiste
chineză	chinoise
chinez	chinois
chineze	chinoises
chinezi	chinois
chirurg	chirurgien
chirurgicale	chirurgicales
cianură	cyanure
cicliști	cyclistes
ciclu	cycle
cifră	chiffre
cifrele	chiffres
cilindrică	cylindrée
cimitir	cimetière
cimitire	cimetières
cimitirul	cimetière
cinematografică	cinématographique
cinematografice	cinématographique
ciocolată	chocolat
cipriotă	chypriote
cipriot	chypriote
circuitele	circuits
circuitelor	circuits
circuitul	circuit
circulă	circule
circula	circuler
circulară	circulaire
circulație	circulation
circul	cirque
circule	circuler
circumscripția	circonscription
circumscripții	circonscriptions
circumstanțe	circonstances
citadelă	citadelle
citat	citation
citează	citent
civică	civique
civic	civique
civice	civique
civilă	civile
civile	civiles
clare	claires
clarificarea	clarifier
clasa	classe
clasă	classe
clase	classes
clasei	classe
clasele	classes
clasică	classique
clasic	classique
clasice	classiques
clasificarea	classification
clasificare	classification
clasificări	classifications
clauza	clause
clauze	clause
clerici	clergé
clienți	client
clienții	clients
clienților	clients
clientul	client
clientului	client
climă	climat
climatice	climatique
climei	climat
clinică	clinique
clinic	clinique
clinice	clinique
clinici	cliniques
clone	clones
clorură	chlorure
coaliția	coalition
coaliție	coalition
coautor	coauteur
cocaină	cocaïne
codificarea	codification
codificare	codification
codificat	codifié
coerentă	cohérente
coerent	cohérent
coerente	cohérente
cognitivă	cognitif
cognitive	cognitives
coincid	coïncident
coincidență	coïncidence
colaborarea	collaboration
colaborare	collaboration
colaborat	collaboré
colaborator	collaborateur
colaboreze	collaborer
colaterale	collatéraux
colectivă	collective
colectiv	collective
colective	collective
colegul	collègue
colegului	collègue
colesterol	cholestérol
coliziunea	collision
coliziune	collision
coloana	colonne
colonelul	colonel
colonelului	colonel
colonială	coloniale
coloniale	coloniales
colonii	colonies
coloniilor	colonies
colonizarea	colonisation
colonizare	colonies
colonizată	colonisée
columbian	colombien
comanda	commande
comandă	commande
comandant	commandant
comandantul	commandant
comandantului	commandant
comandate	commandé
comando	commandos
combat	combattent
combatere	combattre
combătut	combattu
combină	combine
combina	combiner
combinând	combinant
combinarea	combiner
combinată	combinée
combinație	combinaison
combine	combiner
combustibil	combustible
combustibililor	combustibles
combustibilul	combustible
combustibilului	combustible
comemorarea	commémorer
comemorare	commémoration
comemorat	commémoré
comemorativă	commémoration
comentarii	commentaires
comentariile	commentaires
comentariu	commentaire
comentat	commenté
comentator	commentateur
comentatori	commentateurs
comercială	commerciale
comercial	commercial
comerciale	commerciale
comercializarea	commercialisation
comercializare	commercialisation
comercializării	commercialisation
comercializat	commercialisé
comercializate	commercialisés
comerciant	commerçant
comercianți	commerçants
comercianții	commerçants
comerțul	commerce
comestibil	comestibles
comestibile	comestibles
comisari	commissaires
comisarilor	commissaires
comisarul	commissaire
comisarului	commissaire
comis	commis
comise	commises
comisiei	commission
comisii	commissions
comisiile	comités
comisiilor	commissions
comite	commet
comiterea	commettre
comitet	comité
comitete	comités
comitetul	comité
comitetului	comité
compania	compagnie
companie	compagnie
companiile	compagnies
companiilor	compagnies
comparabilă	comparable
comparabil	comparable
comparabile	comparables
compararea	comparer
comparat	comparé
comparativă	comparative
compasiune	compassion
compatibilă	compatible
compatibil	compatible
compatibile	compatibles
compatibilitatea	compatibilité
compatibilitate	compatibilité
compendiu	compendium
compensa	compenser
compensare	compensation
competența	compétence
competență	compétence
competentă	compétente
competent	compétent
competențe	compétences
competente	compétentes
competențele	compétences
competitiv	compétitif
competitive	compétitive
complementară	complémentaire
complementar	complémentaire
complementare	complémentaires
completă	complète
completa	compléter
completare	complément
completată	complétée
completat	complété
complet	complètement
complete	complète
completeze	compléter
complexă	complexe
complex	complexe
complexe	complexes
complexitatea	complexité
complexitate	complexité
complică	complique
complicată	compliqué
complicat	compliqué
complicate	compliquées
complicații	complications
complice	complices
componenta	composante
componentă	composante
componente	composantes
componentele	composantes
componentelor	composantes
comportamentală	comportementale
comportament	comportement
comportamente	comportements
comportamentul	comportement
comportamentului	comportement
comporte	comporter
compozitorilor	compositeurs
compozitorul	compositeur
compromisul	compromis
compromisuri	compromis
compromite	compromettre
compun	composent
compus	composé
compuse	composées
comună	commune
comun	commun
comune	commune
comunică	communiquent
comunica	communiquer
comunicarea	communication
comunicare	communication
comunicări	communications
comunicării	communication
comunicațiile	communications
comunice	communiquer
comunism	communisme
comunismul	communisme
comunismului	communisme
comunistă	communiste
comunist	communiste
comuniste	communiste
comunitară	communautaire
comunitar	communautaire
comunitare	communautaire
comunitatea	communauté
comunitate	communauté
concentra	concentrer
concentrându-se	concentrant
concentrarea	concentration
concentrare	concentration
concentrată	concentrée
concentrat	concentré
concentrate	concentrées
concentrații	concentrations
concentrează	concentre
concentreze	concentrer
concepte	concepts
conceptele	concepts
conceptelor	concepts
conceptuală	conceptuel
conceptual	conceptuel
conceptul	concept
conceptului	concept
conceput	conçu
concepute	conçues
concluzia	conclusion
concluzie	conclure
concluzii	conclusions
concluziile	conclusions
concretă	concrète
concret	concrète
concrete	concrets
concurența	concurrence
concurență	concurrence
concurent	concurrent
concurente	concurrentes
concurenții	concurrents
concurenților	concurrents
concurs	concours
concursul	concours
condamnă	condamne
condamna	condamner
condamnarea	condamner
condamnare	condamnation
condamnări	condamnations
condamnată	condamnée
condamnat	condamné
condamnate	condamnées
condamnați	condamnés
condiția	condition
condiție	condition
condiții	conditions
condițiile	conditions
condiționat	conditionné
conduită	conduite
conectivitate	connectivité
conexiuni	connexion
conexiunile	connexions
conferă	confère
conferință	conférence
conferințele	conférences
conferit	conféré
confesiuni	confessions
confirma	confirme
confirmă	confirme
confirmând	confirmant
confirmarea	confirmation
confirmare	confirmation
confirmată	confirmée
confirmat	confirmé
confirmate	confirmées
confirme	confirmer
confiscarea	confiscation
conflict	conflit
conflicte	conflits
conflictele	conflits
conflictelor	conflits
conflictul	conflit
conflictului	conflit
conforme	conformes
conformitate	conformément
confortabilă	confortable
confortul	confort
confruntare	confrontation
confruntări	confrontation
confruntările	confrontation
confundă	confond
confundată	confondu
confundat	confondu
confundate	confondus
confuză	confus
confuzia	confusion
confuzie	confusion
confuzii	confusion
conglomerat	conglomérat
congregații	congrégations
congresul	congrès
conotații	connotation
consecutivă	consécutif
consecutiv	consécutive
consecutive	consécutives
consens	consensus
consensul	consensus
conservarea	conservation
conservare	conservation
conservării	conservation
conservatoare	conservatrice
conservator	conservateur
conservatorii	conservateurs
conservatorilor	conservateurs
conserve	conserves
considerabilă	considérable
considerabil	considérable
considerabile	considérables
consideră	considère
considerăm	considérons
considerare	considération
considerată	considéré
considerat	considéré
considerate	considérées
considerente	considérations
consilier	conseiller
consiliere	conseil
consilieri	conseillers
consilierii	conseillers
consilierilor	conseillers
consilii	conseils
consiliile	conseils
consiliilor	conseils
consiliu	conseil
consiliul	conseil
consiliului	conseil
consolida	consolider
consolidarea	consolidation
consolidare	consolidation
consolidării	consolidation
consolidată	consolidée
consolidat	consolidé
consolideze	consolider
conspirație	conspiration
conspiratorii	conspirateurs
constă	consiste
constantă	constante
constant	constamment
constante	constantes
constatat	constaté
constatate	constatées
constitui	constituer
constituie	constitue
constituite	constitués
constituțională	constitutionnelle
constituțional	constitutionnel
constituționale	constitutionnelles
constructivă	constructive
constructiv	constructive
construiască	construire
construi	construire
construiesc	construisent
construiește	construit
construind	construisant
construirea	construire
construită	construite
construite	construites
consulare	consulaires
consulatul	consulat
consulta	consulter
consultanți	consultants
consultarea	consultation
consultări	consultation
consultat	consulté
consulte	consulter
consulul	consul
consumă	consomme
consuma	consommer
consumat	consommé
consumate	consommée
consumator	consommateur
consumatorii	consommateurs
consumatorilor	consommateurs
consumatorului	consommateur
consume	consommer
contabile	comptable
contabilitatea	comptabilité
contactat	contacté
contact	contacts
contacte	contacts
contactele	contacts
contactelor	contacts
contacteze	contacter
contactul	contact
containere	conteneurs
contaminarea	contamination
contaminare	contamination
contaminate	contaminées
contele	comte
contemporană	contemporaine
contemporan	contemporain
contemporane	contemporaine
contemporanilor	contemporains
contestă	conteste
contestată	contestée
contestat	contesté
context	contexte
contexte	contextes
contextul	contexte
conținea	contenait
conține	contient
continentală	continental
continental	continentale
continentale	continentales
continente	continents
continentul	continent
continentului	continent
continuă	continue
continua	continuera
continuat	continué
continue	continuer
continuitatea	continuité
continuu	continu
contraatac	contre-attaque
contraatacul	contre-attaque
contraatacuri	contre-attaques
contrabandă	contrebande
contract	contrat
contracte	contrats
contractele	contrats
contractelor	contrats
contractuale	contractuelles
contractul	contrat
contractului	contrat
contradicție	contradiction
contradicții	contradictions
contradicțiile	contradictions
contradictorii	contradictoires
contradictoriu	contradictoire
contrar	contraire
contrare	contraires
contraspionaj	contre-espionnage
contrastează	contraste
contrazice	contradiction
contribui	contribuer
contribuie	contribue
contribuind	contribuant
contribuit	contribué
contribuția	contribution
contribuție	contribution
contribuții	contributions
contribuțiile	contributions
contribuțiilor	contributions
controla	contrôler
controlată	contrôlée
controlat	contrôlé
controlate	contrôlée
control	contrôle
controlează	contrôlent
controleze	contrôler
controlul	contrôle
controversată	controversé
controversat	controverse
controversate	controverse
contumacie	contumace
convenit	convenu
convenții	conventions
convențiile	conventions
convențiilor	conventions
convențional	conventionnel
convergența	convergence
convergență	convergence
convergentă	convergente
conversații	conversation
conversia	conversion
conversie	conversion
convingă	convaincre
convingătoare	convaincante
convingător	convaincant
convinge	convaincre
convingere	conviction
convinsă	convaincue
convins	convaincu
convinși	convaincus
convocarea	convocation
convocat	convoqué
convoiul	convoi
cooperare	coopération
coopereze	coopérer
coordona	coordonner
coordonarea	coordination
coordonare	coordination
coordonată	coordonnée
coordonat	coordonné
coordonate	coordonnée
coordonator	coordinateur
coordonatorul	coordinateur
coordonează	coordonne
coordoneze	coordonner
copiată	copié
copieze	copier
copiile	copies
coptă	copte
coral	corail
coralilor	corail
cordonul	cordon
corectă	correcte
corect	correctement
corecte	correctes
corecție	correction
coreeană	coréen
coreean	coréen
coreene	coréenne
coreeni	coréens
corespondența	correspondance
corespondență	correspondance
corespundă	correspondre
corespund	correspondent
corespundea	correspondait
corespunde	correspond
coridoare	corridors
coridor	corridor
coridorul	corridor
coroană	couronne
coroane	couronnes
corporală	corporel
corpul	corps
corupție	corruption
corupției	corruption
cosmetice	cosmétiques
cosmopolit	cosmopolite
costă	coûte
costul	coût
costum	costume
cotate	cotées
crearea	créer
creativ	créative
creative	créatives
creativitatea	créativité
creativitate	créativité
creativității	créativité
creator	créateur
creatură	créature
creaturi	créatures
credibilă	crédible
credibile	crédible
credibilitatea	crédibilité
credibilitate	crédibilité
credit	crédit
credite	crédit
creditele	crédits
creditelor	crédit
creștin	chrétien
creștine	chrétienne
creștini	chrétiens
crima	crime
crime	crimes
crimei	crime
criminală	criminelle
criminal	criminel
criminale	criminelles
criteriile	critères
criteriu	critère
criteriul	critère
critică	critique
critica	critiquer
criticat	critiqué
criticate	critiquées
critic	critique
critice	critique
critici	critique
criticile	critiques
criza	crise
criză	crise
crize	crise
crizei	crise
croat	croate
croate	croates
croați	croates
crocodil	crocodile
cromatică	chromatique
cromozomilor	chromosomes
cronică	chronique
cronice	chroniques
cronologică	chronologique
cruciada	croisade
cruciadă	croisade
cruciade	croisade
cruci	croix
crudă	cruel
crude	cruel
crustacee	crustacés
cubanez	cubain
cubaneze	cubaine
culminat	culminant
cultelor	culte
cultivă	cultivent
cultivată	cultivé
cultivate	cultivées
cultive	cultiver
cultură	culture
culturală	culturelle
cultural	culturel
culturale	culturelle
culturii	culture
culturile	cultures
culturilor	cultures
cuprinde	comprend
curba	courbe
curbe	courbe
curbura	courbure
curent	courant
curios	curieux
curiozitate	curiosité
cursa	course
cursă	course
curse	course
cursele	courses
daneză	danoise
danezi	danois
debarce	débarquer
decembrie	décembre
decenii	décennies
deceniu	décennie
deces	décès
decidă	décider
decid	décident
decide	décide
decise	décidés
decisivă	décisive
decisiv	décisive
decisive	décisive
declarând	déclarant
declarată	déclarée
declarat	déclaré
declarate	déclarées
declarație	déclaration
declarații	déclarations
declin	déclin
declinul	déclin
declinului	déclin
decolare	décollage
decret	décret
decrete	décrets
decretele	décrets
decretul	décret
defensivă	défensive
defensiv	défensives
defensive	défensives
deficitul	déficit
deficitului	déficit
definește	définit
defini	définir
definirea	définir
definită	définie
definit	défini
definite	définies
definiții	définitions
definitivă	définitive
definitiv	définitive
degradare	dégradation
delicată	délicat
delicat	délicat
delicate	délicates
delimitarea	délimiter
delimitare	délimitation
demisioneze	démissionner
demnitari	dignitaires
democrația	démocratie
democratică	démocratique
democratic	démocratique
democratice	démocratique
democrație	démocratie
democrației	démocratie
democrații	démocraties
demografic	démographique
demografice	démographique
demografie	démographie
demolate	démolies
demonii	démons
demonstra	démontrer
demonstrând	démontrant
demonstrat	démontré
demonstrează	démontre
demonstreze	démontrer
densă	dense
densitatea	densité
densitate	densité
departament	département
departamente	départements
departamentele	départements
departamentelor	départements
departamentul	département
dependența	dépendance
dependență	dépendance
dependentă	dépendant
dependenței	dépendance
depinde	dépend
deportărilor	déportation
deportat	déporté
deportate	déportées
deportați	déportés
depresia	dépression
depresie	dépression
depresiune	dépression
derivat	dérivé
descendentă	descendante
descendenților	descendants
descoperit	découvert
descoperite	découvertes
descrie	décrire
descriere	description
descrieri	descriptions
descris	décrit
descrise	décrits
deșert	désert
designul	design
destinată	destinée
destinate	destinées
destinație	destination
destinații	destinations
destinele	destins
destinul	destin
detaliile	détails
detaliu	détail
detenție	détention
determină	détermine
determina	déterminer
determinarea	détermination
determinare	détermination
determinată	déterminée
deținut	détenu
devastarea	dévastée
devastată	dévastée
devastat	dévasté
devastator	dévastateur
devastează	dévaste
devenit	devenu
dezacord	désaccord
dezacordul	désaccord
dezastru	désastre
dezastruoasă	désastreuse
dezastruoase	désastreuses
dezastruos	désastreuse
dezordine	désordre
diabet	diabète
diabetul	diabète
diagnosticarea	diagnostic
diagnosticat	diagnostiqué
diagnosticul	diagnostic
diagrame	diagramme
dialect	dialecte
dialecte	dialectes
dialectică	dialectique
dialog	dialogue
dialogul	dialogue
dialogului	dialogue
dialoguri	dialogues
dialogurile	dialogues
diamante	diamants
diamantele	diamants
diaree	diarrhée
diasporei	diaspora
dictat	dictée
dictator	dictateur
dictatorul	dictateur
dictatorului	dictateur
dictatura	dictature
dictatură	dictature
dictaturii	dictature
dicționar	dictionnaire
didactice	didactique
diferență	différence
diferențe	différences
diferențele	différences
diferenția	différencier
diferențiat	différencié
diferențiate	différenciées
diferențierea	différencier
diferite	différentes
dificilă	difficile
dificil	difficile
dificile	difficile
dificultate	difficulté
dificultăți	difficultés
dilema	dilemme
dimensiunea	dimension
dimensiune	dimension
dimensiuni	dimensions
dimensiunii	dimension
dimensiunile	dimensions
dinamica	dynamique
dinamică	dynamique
dinamic	dynamique
dinamice	dynamique
dinastică	dynastique
dinozaur	dinosaure
dinozaurilor	dinosaures
diplomă	diplôme
diplomatic	diplomatique
diplomatice	diplomatique
diplomație	diplomatie
diplomației	diplomatie
diplomații	diplomates
diplome	diplôme
directă	direct
direct	directe
directe	directes
direcție	direction
direcții	directions
direcțiile	directions
directiva	directive
directivă	directive
directive	directives
directivei	directive
directivele	directives
directoarea	directrice
director	directeur
directori	directeurs
directorii	directeurs
directorilor	directeurs
directorul	directeur
directorului	directeur
disciplină	discipline
disciplinare	disciplinaire
disciplinei	discipline
disciplinele	disciplines
discotecă	discothèque
discretă	discret
discriminarea	discrimination
discriminare	discrimination
discriminări	discriminations
discriminării	discrimination
discurs	discours
discursul	discours
discursului	discours
discursuri	discours
discursurile	discours
discutabilă	discutable
discuta	discuter
discutată	discutée
discutat	discuté
discutate	discutées
discuții	discussions
disident	dissident
dispare	disparaît
dispersia	dispersion
disponibilă	disponible
disponibil	disponible
disponibile	disponibles
disponibilitatea	disponibilité
disponibilitate	disponibilité
dispoziție	disposition
dispozitive	dispositifs
dispozitivele	dispositifs
dispun	disposent
dispune	dispose
dispusă	disposée
dispus	disposé
dispuse	disposés
distanță	distance
distilarea	distillation
distinctă	distincte
distincte	distinctes
distincție	distinction
distinctive	distinctifs
disting	distinguent
distinge	distingue
distribui	distribuer
distribuie	distribuer
distribuirea	distribution
distribuire	distribution
distribuită	distribuée
distribuit	distribué
distribuite	distribués
distribuitori	distributeurs
distribuție	distribution
districtul	district
distructive	destructrice
distruge	détruire
distruse	détruits
divergente	divergentes
diversă	diversifiée
diversificarea	diversifier
diversificare	diversification
diversificată	diversifié
diversificate	diversifiée
diversitatea	diversité
diversitate	diversité
diversității	diversité
diversiune	diversion
divertisment	divertissement
divină	divine
divizat	divisé
divizate	divisées
diviziunea	division
diviziuni	divisions
diviziunile	divisions
divorț	divorce
divorțeze	divorcer
divorțului	divorce
doarmă	dormir
doarme	dorment
doctorale	doctorat
doctoranzi	doctorants
doctrina	doctrine
doctrină	doctrine
doctrinei	doctrine
doctrinelor	doctrines
documentară	documentaire
documentar	documentaire
documentarea	documentaire
documentarului	documentaire
documentată	documenté
documentat	documenté
documentate	documentées
documentația	documentation
documente	documents
documentele	documents
documentelor	documents
documentul	document
dogmă	dogme
dogmatică	dogmatique
dogme	dogmes
dogmele	dogmes
dolar	dollar
dolari	dollars
dolarul	dollar
domestică	domestique
domestice	domestique
domiciliu	domicile
domină	domine
domina	dominer
dominantă	dominante
dominante	dominantes
dominată	dominé
dominat	dominé
dominate	dominées
dominația	domination
domine	dominer
donator	donateur
dosar	dossier
drama	drame
dramă	drame
dramatică	dramatique
dramatic	dramatique
dramatice	dramatique
drame	drames
drastică	drastique
drastic	drastiquement
droguri	drogue
drogurile	drogues
dulce	douce
durat	duré
duratei	durée
dureze	durer
duzină	douzaine
echivalentă	équivalente
echivalente	équivalentes
echivalent	équivalent
ecleziastică	ecclésiastique
ecleziastice	ecclésiastiques
ecologică	écologique
ecologic	écologique
ecologice	écologiques
ecologie	écologie
ecologiei	écologie
economia	économie
economică	économique
economic	économique
economice	économique
economie	économie
economiei	économie
economii	économie
economiile	économies
economist	économiste
economiști	économistes
economistul	économiste
ecosistem	écosystème
ecosisteme	écosystèmes
ecuatorială	équatoriale
editor	éditeur
editorială	éditoriale
editoriale	éditoriales
educare	éducatives
educative	éducatives
efecte	effets
efect	effet
efectivă	effective
efectuate	effectués
efectuat	effectué
efectueze	effectuer
eficace	efficace
eficacitatea	efficacité
eficientă	efficace
eficiente	efficace
eficient	efficacement
egiptean	égyptien
egiptene	égyptiennes
egipteni	égyptiens
elaborată	élaborée
elaborate	élaborées
elaborat	élaboré
elaboreze	élaborer
electorală	électorale
electorale	électorale
electoral	électoral
electorat	électorat
electoratul	électorat
electrică	électricité
electrice	électriques
electric	électrique
electricitate	électricité
electrificată	électrifié
electromagnetice	électromagnétiques
electronică	électronique
electronice	électroniques
electronic	électronique
electronicii	électronique
elegante	élégantes
elementară	élémentaire
elementare	élémentaires
elementar	élémentaire
elemente	éléments
element	élément
elibera	libérer
eliberează	libère
elibereze	libère
elicoptere	hélicoptères
elicopterele	hélicoptères
elicopter	hélicoptère
elicopterul	hélicoptère
eligibil	éligible
elimina	éliminer
eliminând	éliminant
eliminată	éliminée
eliminat	éliminé
elimine	éliminer
elită	élite
elitei	élites
elitele	élites
emanciparea	émancipation
emblematic	emblématique
emigrat	émigré
emigreze	émigrer
emise	émises
emoțional	émotionnel
empirică	empirique
empirice	empirique
empiric	empirique
endemică	endémique
endemice	endémiques
energetice	énergétique
energetic	énergie
energia	énergie
energic	énergique
energie	énergie
energiile	énergies
enigmă	énigme
enormă	énorme
enorme	énormes
enorm	énorme
entitate	entité
entități	entités
entuziasm	enthousiasme
entuziasmul	enthousiasme
entuziast	enthousiaste
enzimă	enzyme
enzimele	enzymes
eolian	éolien
eoliene	éolienne
epidemie	épidémie
epidemiei	épidémie
epidemii	épidémie
epidemiile	épidémies
episoade	épisodes
episod	épisode
ereditare	héréditaires
eroare	erreur
eronate	erronées
escală	escale
esențială	essentielle
esențiale	essentielles
esențial	essentiel
estetice	esthétiques
estima	estimer
estimări	estimations
estimată	estimée
estimate	estimées
estimat	estimé
estimează	estime
estonian	estonien
est-vest	est-ouest
etnice	ethniques
etnic	ethnique
europeană	européenne
european	européen
europene	européenne
europeni	européens
evacuate	évacuées
evacueze	évacuer
evalua	évaluer
evaluate	évaluées
evaluat	évalué
evaluează	évalue
evenimente	événements
eveniment	événement
eventuala	éventuelle
evidente	évidentes
evident	évident
evită	évite
evoluat	évolué
evolueze	évoluer
evoluție	évolution
exacte	exactes
exagerare	exagéré
exagerată	exagérée
exagerat	exagéré
examina	examiner
examinat	examiné
examinează	examine
excelența	excellence
excelență	excellence
excelentă	excellent
excelente	excellentes
excelent	excellent
excepțională	exceptionnel
excepționale	exceptionnelle
excepțional	exceptionnel
exces	excès
excesivă	excessive
excesive	excessive
excesiv	excessif
exclude	exclure
exclusă	exclue
excluse	exclus
exclus	exclu
excluși	exclus
exclusivă	exclusive
exclusive	exclusives
exclusiv	exclusivement
excluzând	excluant
excursii	excursions
executivă	exécutive
executive	exécutif
executiv	exécutif
executivi	exécutifs
exemplară	exemplaire
exemplare	exemplaires
exemplar	exemplaire
exemple	exemples
exercită	exercent
exercita	exercer
exercitată	exercée
exercitate	exercée
exercitat	exercé
exercite	exercer
exerciții	exercices
exercițiu	exercice
exilat	exilé
există	existe
existentă	existante
existența	existence
existență	existence
existente	existantes
existent	existant
existențială	existentielle
exotică	exotique
exotice	exotiques
expansiunea	expansion
expansiune	expansion
experiența	expérience
experiență	expérience
experiențe	expériences
experimenta	expérimenter
experimentală	expérimental
experimentale	expérimentales
experimental	expérimental
experimentele	expérimentations
experimentelor	expérimentation
experimenteze	expérimenter
experți	experts
experții	experts
explicită	explicite
explicite	explicites
explicit	explicite
explodat	explosé
explodează	explosent
explora	explorer
explorarea	explorer
explorată	explorée
explorat	exploré
exploreze	explorer
explozie	explosion
explozii	explosions
explozivă	explosive
explozive	explosives
exponențială	exponentielle
exponențial	exponentielle
exportate	exportées
exportat	exporté
expresie	expression
expresii	expressions
expresiile	expressions
exprimă	exprime
exprima	exprimer
exprime	exprimer
expulzați	expulsés
expune	expose
exterior	extérieur
exterminare	extermination
externe	extérieure
extern	externe
externi	extérieurs
extracție	extraction
extrage	extraire
extraordinară	extraordinaire
extraordinare	extraordinaire
extraordinar	extraordinaire
extrase	extraits
extrema	extrême
extremă	extrême
extreme	extrême
extremiste	extrémistes
fabricarea	fabrication
fabricat	fabriqué
facilita	faciliter
facilitând	facilitant
facilitarea	faciliter
facilitat	facilité
faciliteze	faciliter
factor	facteur
factori	facteurs
factorii	facteurs
factorul	facteur
factură	facture
faimoase	fameuses
faimoasei	fameuse
faliment	faillite
false	fausses
falsificarea	falsification
familia	famille
familială	familial
familiale	familiales
familie	familiale
familiei	famille
familii	famille
familiile	familles
familiilor	famille
fanatic	fanatique
fantastică	fantastique
fantastic	fantastique
fantezia	fantasme
fantezie	fantasme
fantome	fantômes
fapte	actes
farmaceutice	pharmaceutique
farmaceutic	pharmaceutique
farmacie	pharmacies
farmacist	pharmacien
farsă	farce
fascinat	fasciné
fascism	fascisme
fascismul	fascisme
fascismului	fascisme
fasciste	fascistes
fascist	fasciste
fatală	fatal
fatale	fatales
faună	faune
faunei	faune
favorabile	favorables
favorabil	favorable
favorizate	favorisée
favorizat	favorisé
favorizează	favorise
federală	fédérale
federale	fédérale
federal	fédéral
feline	félins
feminismul	féminisme
feministă	féministe
feminist	féministe
ferestre	fenêtres
fermă	ferme
fermitate	fermeté
feroviară	ferroviaire
feroviare	ferroviaire
feroviar	ferroviaire
fertile	fertiles
fertil	fertile
fertilitatea	fertilité
fertilitate	fertilité
festivaluri	festival
fiabilitatea	fiabilité
fibră	fibre
fibrele	fibres
fibrelor	fibres
fidelă	fidèle
fidel	fidèle
fideli	fidèles
filiala	filiale
filiale	filiales
filialele	filiales
filmat	filmé
filosofice	philosophique
filosofie	philosophie
filozofie	philosophie
filtrare	filtrage
filtre	filtres
filtru	filtre
finală	finale
finale	finales
financiară	financière
financiare	financière
financiar	financier
finanța	financer
finanțarea	financer
finanțare	financement
finanțată	financée
finanțate	financées
finanțat	financé
finanțele	finances
finanțelor	finances
finanțeze	financer
finite	finie
finlandeze	finlandaise
finlandez	finlandais
finlandezi	finlandais
fiscală	fiscale
fiscale	fiscales
fiscal	fiscalité
fisiune	fission
flexibilă	flexible
flexibile	flexible
flexibil	flexible
flexibilitate	flexibilité
floră	flore
florei	flore
flota	flotte
flote	flottes
flotei	flotte
flotele	flottes
flotila	flottille
flotilei	flottille
fluctuații	fluctuations
fluide	fluides
fluid	fluides
fluviale	fluvial
fluvial	fluviale
folclor	folkloriques
fondatoare	fondateurs
fondator	fondateur
fondatorii	fondateurs
fonduri	fonds
forestieră	forestière
forestiere	forestiers
forestier	forestière
formă	forme
formală	formel
formale	formelle
formal	formel
formarea	formation
formare	formation
formate	formats
formatele	formats
format	formé
formatul	format
formează	forment
forme	formes
formele	formes
formeze	former
formulă	formule
formularea	formulation
formulare	formulaires
formulări	formulations
formulată	formulée
formulat	formulé
formulează	formule
formule	formules
forță	force
fortăreața	forteresse
fortăreață	forteresse
forțele	forces
forumul	forum
forumuri	forums
fosilă	fossile
fosili	fossiles
fotografiat	photographié
fotografie	photographie
fotografii	photographies
fragilă	fragile
fragile	fragiles
fragil	fragile
fragmentarea	fragmentation
fragmentare	fragmentation
fragmentată	fragmentaire
fragmentat	fragmentaire
frânare	freinage
franceză	française
franceze	française
francezi	français
frecvente	fréquentes
frontieră	frontière
frontierei	frontière
frontierele	frontières
frontierelor	frontières
fronturi	fronts
fronturile	fronts
fructe	fruits
fumat	fumer
funcționa	fonctionner
funcțională	fonctionnel
funcționale	fonctionnelle
funcțional	fonctionnel
funcționalitatea	fonctionnalité
funcționar	fonctionnaire
funcționari	fonctionnaires
funcționat	fonctionné
funcționeze	fonctionner
fundamentală	fondamental
fundamentale	fondamentales
fundamental	fondamental
fundamentele	fondements
fundamentul	fondement
fundație	fondation
funeraliile	funérailles
furnizarea	fourniture
furnizată	fournie
furnizate	fournies
furnizat	fourni
furnizor	fournisseur
fuziune	fusion
galeria	galerie
gamă	gamme
garaj	garage
garanta	garantir
garantarea	garantie
garantată	garanti
garantate	garantis
garantat	garanti
garantează	garantit
garanție	garantie
garanții	garanties
gardă	garde
gardian	gardien
gardianul	gardien
gardienii	gardiens
genera	générer
generală	générale
generale	générale
genetice	génétique
genitale	génitales
genocid	génocide
genocidul	génocide
genocidului	génocide
geografice	géographique
geografie	géographie
geologică	géologique
geologice	géologique
geometrice	géométrique
geometrie	géométrie
geopolitice	géopolitique
georgiană	géorgienne
georgian	géorgien
georgiene	géorgienne
gestionarea	gestion
gestionare	gestion
gesturi	gestes
ghetou	ghetto
ghetouri	ghettos
gigant	géant
glaciară	glaciaire
globală	globale
glorie	gloire
glorioasă	glorieuse
grădină	jardin
graduală	graduelle
grafice	graphique
grame	grammes
gratuită	gratuite
gratuite	gratuites
gratuit	gratuitement
gravă	grave
grave	graves
gravitatea	gravité
grecești	grecques
grotesc	grotesque
grupul	groupe
guverna	gouverner
guvernamentală	gouvernemental
guvernamentale	gouvernementales
guvernamentali	gouvernementaux
guvernare	gouvernance
guvernată	gouvernée
guvernat	gouverné
guvernator	gouverneur
guvernatori	gouverneurs
guvernatorii	gouverneurs
guvernatorul	gouverneur
guvernează	gouvernent
guverne	gouvernements
guvernele	gouvernements
guvern	gouvernement
guvernul	gouvernement
habitate	habitats
habitatelor	habitats
habitatul	habitat
habitatului	habitat
haotică	chaotique
haotic	chaotique
harta	carte
hectare	hectares
hectar	hectare
hegemonia	hégémonie
hemoragii	hémorragie
hibride	hybrides
hibrid	hybride
hidraulică	hydraulique
hidrocarburi	hydrocarbures
hidroelectrică	hydroélectrique
hidroelectrice	hydroélectrique
hidrogen	hydrogène
hidrografic	hydrographique
hochei	hockey
holocaustul	holocauste
holocaustului	holocauste
homosexuale	homosexuelles
homosexual	homosexuel
homosexuali	homosexuels
homosexualilor	homosexuels
homosexualitatea	homosexualité
homosexualitate	homosexualité
homosexualității	homosexualité
hormoni	hormones
hormonii	hormones
icoane	icônes
ideală	idéal
ideale	idéales
ideal	idéal
idealist	idéaliste
identică	identique
identice	identiques
identic	identique
identifică	identifie
identifica	identifier
identificarea	identifier
identificare	identification
identificată	identifiée
identificate	identifiées
identificat	identifié
identifice	identifier
identitatea	identité
identitate	identité
identități	identité
identității	identité
ideologia	idéologie
ideologică	idéologique
ideologice	idéologique
ideologic	idéologique
ideologie	idéologie
ideologiei	idéologie
ideologii	idéologie
ierarhia	hiérarchie
ierarhice	hiérarchique
ierarhie	hiérarchie
ierarhiei	hiérarchie
ignoră	ignore
ignorând	ignorant
ignorată	ignorée
ignorate	ignorés
ignorat	ignoré
ignore	ignorer
ilegală	illégal
ilegale	illégale
ilegal	illégal
ilegitim	illégitime
ilustra	illustrer
ilustrată	illustré
ilustrează	illustre
iluștri	illustres
iluzie	illusoire
imagina	imaginer
imaginară	imaginaire
imaginare	imaginaires
imaginație	imagination
imaginat	imaginé
imaginea	image
imagine	image
imagini	images
imaginile	images
imediată	immédiat
imediate	immédiate
imediat	immédiatement
imigranții	immigrants
imigranți	immigrants
imigranților	immigrants
imigrația	immigration
imigrației	immigration
imigrație	immigration
iminent	imminent
imitat	imiter
imobiliară	immobilier
imobiliare	immobilière
imobiliar	immobilier
impact	impact
impactul	impact
imperativ	impératif
imperfect	imparfait
implică	implique
implicații	implications
implicită	implicite
implicit	implicitement
importanța	importance
importanță	importance
importantă	importante
importante	importantes
importate	importées
importat	importé
import	importation
importuri	importations
importurile	importations
imposibilă	impossible
imposibile	impossibles
imposibil	impossible
impozit	impôt
impresia	impression
impresie	impression
impresiile	impressions
impresionantă	impressionnant
impresionante	impressionnantes
impresionant	impressionnant
improvizat	improvisation
impuls	impulsion
impulsul	impulsion
impulsuri	impulsions
impune	impose
impunerea	imposer
impusă	imposé
impuse	imposées
impus	imposé
imunitar	immunitaire
imunitatea	immunité
imunitate	immunité
imunității	immunité
inaugurarea	inauguration
inaugurare	inaugurale
inaugurată	inaugurée
inaugurat	inauguré
încadrat	encadré
incapabilă	incapable
incapabil	incapable
incapacitatea	incapacité
incapacitate	incapacité
încarcerat	incarcéré
incendii	incendies
incendiile	incendies
incendiilor	incendies
incendiu	incendie
incertă	incertain
incert	incertain
incertitudinea	incertitude
incertitudine	incertitude
incidente	incidents
incidentul	incident
incidentului	incident
includă	inclure
includea	incluait
include	inclut
includ	incluent
inclusă	incluse
incluse	incluses
incolor	incolore
incompatibile	incompatibles
incompletă	incomplet
incomplete	incomplète
incomplet	incomplète
încorporate	incorporées
incredibile	incroyables
incredibil	incroyable
încurajarea	encourageant
incursiuni	incursions
independența	indépendance
independență	indépendance
independentă	indépendant
independenței	indépendance
independenți	indépendants
independent	indépendant
indiană	indien
indian	indien
indică	indique
indicând	indiquant
indicativ	indicatif
indicatorii	indicateurs
indicator	indicateur
indice	indiquer
indicele	indice
indicelui	indice
indicii	indices
indiciu	indication
indiene	indiennes
indiferență	indifférence
indigenă	indigène
indigene	indigènes
indirectă	indirecte
indirecte	indirectes
indispensabilă	indispensable
indispensabile	indispensables
indispensabil	indispensable
individ	individu
individuală	individuel
individuale	individuelles
individual	individuel
individului	individu
indivizi	individus
indivizilor	individus
indonezian	indonésien
industria	industrie
industrială	industrielle
industrial	industriel
industrializare	industrialisation
industrializării	industrialisation
industriei	industrie
industrie	industrie
industrii	industrie
industriile	industries
industriilor	industries
ineficientă	inefficace
ineficiente	inefficace
ineficient	inefficace
inerente	inhérentes
inevitabilă	inévitable
inevitabil	inévitable
inexistentă	inexistant
inexistent	inexistant
infectate	infectées
infectat	infecté
infecție	infection
infecțioase	infectieuses
infiltrarea	infiltration
infinit	indéfiniment
inflația	inflation
inflației	inflation
inflație	inflation
influența	influence
influență	influence
influentă	influent
influențată	influencée
influențate	influencées
influențat	influencé
influente	influentes
influențele	influences
influențeze	influencer
influenți	influents
informa	informer
informală	informel
informal	informel
informarea	information
informare	information
informatică	informatique
informatice	informatiques
informatic	informatique
informației	information
informații	informations
informațiile	informations
informați	informés
informat	informé
informator	informateur
informează	informe
informeze	informer
infrastructură	infrastructure
infrastructura	infrastructures
infrastructurii	infrastructures
ingineria	ingénierie
inginerie	ingénierie
inginer	ingénieur
ingrediente	ingrédients
ingredientele	ingrédients
ingredient	ingrédient
inițială	initiale
inițiale	initiales
inițial	initial
inițiativa	initiative
inițiativă	initiative
inițiativei	initiative
inițiative	initiative
inițiativele	initiatives
inovații	innovations
inovatoare	innovante
inovator	innovant
înregistrarea	enregistrement
înregistrare	enregistrement
înregistrări	enregistrements
înregistrării	enregistrement
înregistrările	enregistrements
înregistrată	enregistrée
înregistrate	enregistrées
înscrise	inscrites
insecte	insectes
insistă	insiste
insistența	insistance
inspecție	inspection
inspectorul	inspecteur
inspiră	inspire
inspira	inspirer
inspirată	inspirée
inspirate	inspirées
inspirația	inspiration
inspirație	inspiration
inspirați	inspirés
inspirat	inspiré
inspire	inspirer
instabilă	instable
instabile	instable
instabil	instable
instabilitatea	instabilité
instabilitate	instabilité
instala	installer
instalare	installation
instalată	installé
instalate	installés
instaleze	installer
instanță	instance
instantanee	instantanée
instantaneu	instantané
institutele	instituts
instituției	institution
instituție	institution
instituții	institutions
instituțiile	institutions
instituțiilor	institutions
instituțională	institutionnelle
instituționale	institutionnelles
instituțional	institutionnel
institutul	institut
instrucțiuni	instructions
instrucțiunile	instructions
instructori	instructeurs
instrumentală	instrumentale
instrumente	instruments
instrumentele	instruments
instrumentelor	instruments
insuficientă	insuffisant
insuficiente	insuffisantes
insuficient	insuffisant
insulară	insulaire
intactă	intacte
intacte	intactes
intact	intacte
integra	intégrer
integrantă	intégrante
integrare	intégration
integrată	intégrée
integrate	intégrée
integrat	intégré
integrează	intègre
integreze	intégrer
integritatea	intégrité
integritate	intégrité
integrității	intégrité
intelectuală	intellectuelle
intelectuale	intellectuelle
intelectualii	intellectuels
intelectuali	intellectuels
inteligența	intelligence
inteligentă	intelligente
inteligente	intelligente
inteligent	intelligent
intensă	intense
intense	intenses
intens	intense
intensitatea	intensité
intensivă	intensive
intensive	intensif
intensiv	intensive
intenția	intention
intenții	intentions
intențiile	intentions
intenționat	intentionnellement
intenționează	intention
interacționa	interagir
interacțiunea	interaction
interacțiune	interaction
interactivă	interactive
interactive	interactives
interactiv	interactif
interceptat	intercepté
intercontinentală	intercontinentale
interdicție	interdiction
interdisciplinară	interdisciplinaire
interdisciplinar	interdisciplinaire
interesantă	intéressant
interesante	intéressantes
interesant	intéressant
interesată	intéressée
interesate	intéressées
interesat	intéressé
interesează	intéresse
interfață	interface
interfețe	interface
interimară	intérim
intermediară	intermédiaire
internă	interne
internațională	internationale
internaționale	internationale
internațional	international
interne	internes
intern	interne
interogare	interrogatoires
interogat	interrogé
interpreta	interpréter
interpretarea	interprétation
interpretare	interprétation
interpretării	interprétation
interpretări	interprétation
interpretată	interprété
interpretate	interprétées
interpretat	interprété
interpretează	interprète
interpreteze	interprétée
interpreții	interprètes
interpreților	interprètes
interpret	interprète
interpretul	interprète
intervale	intervalles
interveni	intervenir
intervenit	intervenu
intervenția	intervention
intervenției	intervention
intervenție	intervention
intervină	intervenir
intervine	intervient
intervin	interviennent
interviu	interview
interviul	interview
interviurile	interviews
intime	intimes
intitulată	intitulé
intitulate	intitulées
intitulat	intitulé
intra	entrera
întreprins	entrepris
intrinsecă	intrinsèque
intrinsec	intrinsèque
introducă	introduire
introducând	introduisant
introduce	introduire
introducerea	introduction
introducere	introduction
introduc	introduisent
introductiv	introduction
introdusă	introduite
introdus	introduit
întrunit	réuni
inundații	inondations
inundațiilor	inondations
inutilă	inutile
inutile	inutiles
inutil	inutile
invazie	invasion
invazii	invasion
invaziilor	invasions
inventar	inventaire
inventată	inventée
inventat	inventé
inventatori	inventeurs
inventator	inventeur
inventatorul	inventeur
invenții	invention
invențiile	inventions
inversă	inversée
inversate	inversé
inversat	inversé
invers	inverse
investească	investir
investiție	investissement
investițiile	investissements
investit	investi
investitorii	investisseurs
investitorilor	investisseurs
invită	invite
invitată	invitée
invitați	invités
invitat	invité
invizibilă	invisible
invizibile	invisibles
invocând	invoquant
involuntar	involontairement
irakiene	irakiennes
irakieni	irakiens
iraniană	iranienne
iranian	iranien
iraniene	iranienne
iranieni	iraniens
ireversibile	irréversible
ireversibil	irréversible
irigație	irrigation
irlandeză	irlandaise
irlandeze	irlandaise
irlandezi	irlandais
irlandez	irlandais
ironia	ironie
ironic	ironie
islamică	islamique
islamice	islamique
islamic	islamique
islamul	islam
islandeză	islandaise
islandeze	islandaise
islandez	islandais
israeliană	israélienne
israelian	israélien
israeliene	israélienne
israelieni	israéliens
istoria	histoire
istorică	historique
istorice	historique
istoric	historique
istorie	histoire
istoriei	histoire
istorii	histoires
italiana	italien
italiană	italienne
italian	italien
italiene	italienne
italieni	italiens
iugoslav	yougoslaves
izotopii	isotopes
jandarmerie	gendarmerie
jandarmeriei	gendarmerie
japonezi	japonais
judiciară	judiciaire
judiciare	judiciaire
judiciar	judiciaire
jungla	jungle
junglă	jungle
juridică	juridique
juridice	juridique
juridic	juridique
jurisprudența	jurisprudence
juriști	juristes
jurnalism	journalisme
jurnalismul	journalisme
jurnalistă	journaliste
jurnalistic	journalistique
jurnaliștii	journalistes
jurnaliști	journalistes
jurnalist	journaliste
jurnalistul	journaliste
justifică	justifie
justifica	justifier
justificarea	justification
justificare	justifier
justificată	justifie
justificat	justifie
justifice	justifier
kilograme	kilogrammes
kilometri	kilomètres
kilometru	kilomètre
kurde	kurdes
labirint	labyrinthe
laboratoare	laboratoires
laboratoarele	laboratoires
lacrimi	larmes
laice	laïcs
lansate	lancés
lapte	laitiers
largă	large
lasă	laisse
latina	latin
latine	latin
lectură	lecture
legală	légale
legale	légale
legalitatea	légalité
legalitate	légalité
legal	légal
legenda	légende
legendar	légendaire
legislația	législation
legislației	législation
legislație	législation
legislativă	législative
legislativ	législatif
legislatură	législature
legislaturi	législature
legitime	légitimes
legitimitatea	légitimité
legitimitate	légitimité
legitim	légitime
lentă	lente
lente	lentes
lesbiene	lesbiennes
letonă	lettone
letoni	lettons
leton	letton
liberală	libérale
liberale	libérale
liberă	libre
liberalism	libéralisme
liberalismul	libéralisme
liberalismului	libéralisme
liberalizarea	libéralisation
liberalizare	libéralisation
liberal	libéral
libere	libre
liber	libre
libertatea	liberté
libertate	liberté
libertății	liberté
libian	libyen
licență	licence
licențe	licence
lideri	leaders
lider	leader
limita	limite
limită	limite
limitarea	limiter
limitare	limitation
limitări	limitations
limitată	limité
limitate	limitée
limitat	limité
limitează	limite
limitele	limites
limite	limites
limitelor	limites
limiteze	limiter
linear	linéaire
lingvistică	linguistique
lingvistice	linguistique
lingvistic	linguistique
liniară	linéaire
liniar	linéaire
linie	ligne
liniile	lignes
listă	liste
listele	listes
listelor	listes
literal	littéral
literalmente	littéralement
literară	littéraire
literare	littéraire
literar	littéraire
literatura	littérature
literatură	littérature
literaturii	littérature
litru	litre
lituaniană	lituanienne
lituanian	lituanien
lituaniene	lituanienne
lituanieni	lituaniens
locală	locale
locale	locales
localizarea	localiser
localizată	localisé
local	localement
locomotivă	locomotive
locomotivele	locomotives
logică	logique
logice	logiques
logic	logique
logistică	logistique
logistice	logistiques
logistic	logistique
londoneze	londoniens
londonez	londonien
longevitatea	longévité
luciditate	lucidité
lucid	lucide
luminoasă	lumineuse
lungi	longs
lupta	lutte
luptat	lutté
macedoneană	macédonienne
macedonean	macédonien
mafiei	mafia
mafiot	mafieux
magică	magique
magice	magiques
magic	magique
majoritară	majoritaire
malarie	malaria
maltez	maltais
mamifere	mammifères
mamifer	mammifère
mandatele	mandats
mandatelor	mandats
mandate	mandats
mandatul	mandat
mandatului	mandat
manevră	manœuvre
manevrele	manœuvres
manevre	manœuvrer
manifestă	manifeste
manifestare	manifestation
manifestat	manifesté
manipula	manipuler
manipularea	manipulation
manipulat	manipulé
manuală	manuel
manuale	manuelles
manual	manuel
manuscris	manuscrit
maraton	marathon
marca	marquage
marcarea	marquage
marginală	marginal
marginale	marginales
marină	marine
marine	marines
maritimă	maritime
maritime	maritimes
maritim	maritime
marketingului	marketing
marmura	marbre
marocan	marocain
martir	martyr
marxismul	marxisme
marxismului	marxisme
marxistă	marxiste
marxist	marxiste
masacrați	massacrés
masacrele	massacres
masacre	massacres
masacrul	massacre
masacrului	massacre
masacru	massacre
masă	masse
masculin	masculine
masele	masses
masive	massive
masiv	massif
măsura	mesure
măsură	mesure
măsurarea	mesurer
măsurare	mesurer
măsurate	mesurées
măsurat	mesuré
măsurile	mesures
măsuri	mesures
matematică	mathématique
matematice	mathématiques
matematic	mathématique
materială	matérielle
materialele	matériel
materialelor	matériel
materiale	matérielles
material	matériel
materie	matière
maternă	maternelle
materne	maternelle
maternitate	maternité
matern	maternel
matrimonială	matrimoniale
matură	mature
mature	matures
maturitatea	maturité
maturitate	maturité
matur	mature
maximă	maximal
maxime	maximales
maxim	maximal
mecanice	mécanique
mecanic	mécanique
mecanismele	mécanismes
mecanismelor	mécanismes
mecanisme	mécanismes
mecanism	mécanisme
mecanismul	mécanisme
mecanismului	mécanisme
medaliei	médaille
mediatică	médiatique
mediatic	médiatique
mediator	médiateur
medicale	médicaux
medical	médical
medicamentele	médicaments
medicament	médicament
medicină	médecine
medievale	médiévale
mediocru	médiocre
mediteraneană	méditerranéen
mediteranean	méditerranéen
mediteraneene	méditerranéenne
melancolie	mélancolie
membră	membre
membre	membres
membru	membre
memorandumul	mémorandum
memoriei	mémoire
memorie	mémoire
mentală	mental
mentalitatea	mentalité
mentalitate	mentalité
mental	mentalement
menționată	mentionnée
menționat	mentionné
mercenarilor	mercenaires
mercenar	mercenaire
mercur	mercure
merită	mérite
meritele	mérites
meritelor	mérites
merite	mérites
mesagerul	messagers
metabolice	métabolisme
metal	métal
metalurgic	métallurgie
metan	méthane
meteorologică	météorologique
meteorologice	météorologiques
meteorologic	météorologique
metoda	méthode
metodă	méthode
metodei	méthode
metodele	méthodes
metode	méthodes
metodologice	méthodologique
metodologic	méthodologique
metodologie	méthodologie
metodologii	méthodologie
metrice	métriques
metroul	métro
metru	mètre
mexicană	mexicaine
mexicane	mexicaines
mexican	mexicain
microfon	microphone
microorganisme	micro-organismes
microunde	micro-ondes
migrația	migration
migrației	migratoire
migrație	migratoire
migratoare	migratoires
miliarde	milliards
miliard	milliard
milioane	millions
milion	million
militantă	militante
militară	militaire
militare	militaire
miliției	milices
milițiile	milices
minele	mines
minelor	mines
minerală	minérale
minerale	minérales
mineral	minéral
minereu	minerai
minereuri	minerai
miniatură	miniature
minieră	minière
miniere	miniers
minimă	minimal
minime	minimales
ministerele	ministères
ministerelor	ministères
ministere	ministères
ministerială	ministérielle
ministeriale	ministérielle
ministerial	ministériel
miniștrii	ministres
miniștrilor	ministres
ministrul	ministre
ministru	ministre
minore	mineures
minoritară	minoritaire
minoritatea	minorité
minoritate	minorité
minor	mineur
mintală	mentale
mintale	mentale
minuscule	minuscules
minute	minutes
minut	minute
miracole	miracle
miracol	miracle
miracolul	miracle
miraculoasă	miracle
miraculos	miracle
misionari	missionnaires
misionar	missionnaire
misiunea	mission
misiune	mission
misiunii	mission
misiuni	mission
misterioase	mystérieuses
mister	mystère
mixtă	mixte
mixte	mixtes
mizerie	misère
moartă	morte
mobilă	mobile
mobile	mobiles
mobilitatea	mobilité
mobilitate	mobilité
mobilității	mobilité
mobilizarea	mobiliser
mobilizare	mobiliser
mobilizării	mobilisation
mobil	mobile
modelele	modèles
modelelor	modèles
modele	modèles
model	modèle
modelul	modèle
moderate	modérée
moderat	modéré
moderator	modérateur
modernă	moderne
moderne	modernes
modernitatea	modernité
modernitate	modernité
modernizarea	moderniser
modernizare	modernisation
modern	moderne
modestă	modeste
modeste	modestes
modest	modeste
modifica	modifier
modificarea	modifier
modificare	modifiant
modificările	modifications
modificări	modification
modificată	modifiée
modificate	modifiées
modificat	modifié
modifice	modifier
modulele	modules
module	modules
moleculei	molécule
molecule	molécule
momentele	moments
momente	moments
momentul	moment
monarhia	monarchie
monarhiei	monarchie
monarhie	monarchie
mondială	mondiale
mondiale	mondiales
mondial	mondiale
moneda	monnaie
monedă	monnaie
monede	monnaie
monetară	monétaire
monetare	monétaire
monetar	monétaire
monolog	monologues
monopol	monopole
monopolul	monopole
monoxid	monoxyde
monstru	monstre
montane	montagne
montate	montés
monumentele	monuments
monumentelor	monuments
monumente	monuments
morală	moral
morale	morales
moralitate	moralité
moral	moralement
mortale	mortelles
mortalitatea	mortalité
mortalitate	mortalité
mortalității	mortalité
mortal	mortel
mortiere	mortier
morți	morts
motivată	motivé
motivat	motivé
motorii	motricité
motor	moteur
motorul	moteur
multimedia	multimédia
multinațională	multinationale
multinaționale	multinationales
multiplă	multiple
multiple	multiples
multiplicare	multiplicateur
multitudine	multitude
municipale	municipales
munte	montagne
muntoase	montagne
murit	morts
musculară	muscle
musulmană	musulman
musulmane	musulmanes
musulmanii	musulmans
musulmanilor	musulmans
muzeu	musée
muzicală	musicale
muzicale	musicales
muzician	musicien
muzicienii	musiciens
muzicieni	musiciens
napoleoniene	napoléoniennes
natalității	natalité
natal	natale
națională	nationale
naționale	nationales
naționalism	nationalisme
naționalismul	nationalisme
naționalismului	nationalisme
naționalistă	nationaliste
naționaliste	nationaliste
naționalist	nationaliste
naționalitate	nationalité
naționalizarea	nationalisation
național	national
națiune	nation
națiuni	nation
naturală	naturel
naturale	naturelles
natural	naturel
natură	nature
naturii	nature
navală	navale
navale	navales
navigheze	naviguer
nazism	nazisme
nazismului	nazisme
nazistă	nazie
naziste	nazie
naziști	nazis
nebuloase	nébuleuse
necesară	nécessaire
necesare	nécessaires
necesar	nécessaire
necesitatea	nécessité
neconvenționale	conventionnelles
nedeterminată	indéterminée
nefavorabile	défavorables
negativă	négative
negative	négatives
negativ	négative
negocia	négocier
negociat	négocié
negocierea	négocier
negocieze	négocier
neguvernamentale	gouvernementales
nelegitim	illégitime
nelimitat	illimité
nepopular	impopulaire
nervos	nerveux
netă	nette
neurologice	neurologiques
neutralitatea	neutralité
neutralitate	neutralité
neutră	neutre
neutre	neutres
neutru	neutre
nichel	nickel
nigerian	nigérian
nivel	niveau
nivelul	niveau
niveluri	niveaux
noastră	notre
noastre	notre
nobila	noble
nobilă	noble
nobile	nobles
nobil	noble
noiembrie	novembre
nomad	nomade
nomazi	nomades
nord-americane	nord-américaine
nord-american	nord-américain
nord-estul	nord-est
nordice	nordiques
nord-vest	nord-ouest
nord-vestul	nord-ouest
normală	normal
normale	normales
normal	normalement
normandă	normand
norvegian	norvégien
nostru	notre
nucleară	nucléaire
nucleare	nucléaire
nuclear	nucléaire
numere	numéros
nutritive	nutriments
obiectivele	objectifs
obiectiv	objectif
obiectivul	objectif
obligând	obligeant
obligă	oblige
obliga	obliger
obligată	obligée
obligate	obligés
obligație	obligation
obligațiile	obligations
obligațiilor	obligations
obligați	obligés
obligațiuni	obligations
obligat	obligé
obligatorie	obligatoire
obligatorii	obligatoire
obligatoriu	obligatoire
oblige	obliger
obscură	obscure
obscure	obscures
obscur	obscure
observă	observe
observare	observation
observațiile	observations
observat	observé
observatorii	observateurs
observatori	observateurs
observator	observatoire
obsesie	obsession
obstacolele	obstacles
obstacole	obstacles
obstacol	obstacle
ocazionale	occasionnelles
occidentală	occidental
occidentale	occidentales
oceanice	océaniques
ocean	océan
octombrie	octobre
ocupanții	occupants
ocupă	occupe
ocupate	occupées
ocupat	occupé
ocupe	s'occuper
ofensiva	offensive
ofensivă	offensive
ofensivei	offensive
ofensive	offensive
oferă	offre
oferea	offrait
oferită	offerte
oferite	offertes
oferte	offres
oficială	officielle
oficiale	officielles
oficial	officiel
omagiu	hommage
omogenă	homogène
omogene	homogènes
omogen	homogène
onora	honorer
onorat	honoré
operațională	opérationnelle
operaționale	opérationnelles
operațional	opérationnel
operațiune	opération
operatorii	opérateurs
operator	opérateur
opiniei	opinion
opinie	opinion
opiniile	opinions
opinii	opinions
oportunitate	opportunité
oportunități	opportunités
optat	opté
optime	optimale
optimist	optimiste
optimizarea	optimiser
optim	optimal
opțiune	option
opuse	opposées
oracolul	oracle
orală	orale
orale	orales
orare	horaires
orchestră	orchestre
orchestrei	orchestre
ordinară	ordinaire
ordinare	ordinaire
ordonată	ordonnée
ordonate	ordonnées
ordonat	ordonné
organele	organes
organelor	organes
organe	organes
organică	organique
organice	organiques
organic	organique
organismele	organismes
organismelor	organismes
organisme	organismes
organism	organisme
organismul	organisme
organismului	organisme
organiza	organiser
organizare	organisation
organizată	organisé
organizate	organisée
organizație	organisation
organizațiile	organisations
organizațiilor	organisations
organizații	organisation
organizațională	organisationnelle
organizat	organisé
organizatorii	organisateurs
organizatorilor	organisateurs
organizatori	organisateurs
organizator	organisateur
organizează	organise
organizeze	organiser
organ	organe
organul	organe
orientarea	orientation
orientare	orientation
orientări	orientations
orientată	orientée
orientat	orienté
originală	originale
originale	originales
originalitate	originalité
originalul	original
originare	originaires
originea	origine
origine	origine
originile	origines
orizontală	horizontale
orizontale	horizontales
orizontal	horizontal
orizont	horizon
orizonturi	horizons
ornamentale	ornementales
ortodocși	orthodoxes
ortodoxe	orthodoxe
ortodox	orthodoxe
ostilă	hostile
ostile	hostile
ostil	hostile
ostilitate	hostilité
otomane	ottomane
otoman	ottoman
pachet	paquet
pacient	patient
pacientului	patient
palestiniană	palestinienne
palestinian	palestinien
palestiniene	palestinienne
palestinieni	palestiniens
palmier	palme
panica	panique
panică	panique
panou	panneau
pantalonii	pantalons
papei	papale
parabolă	parabole
parada	parade
paradigmă	paradigme
paradoxal	paradoxalement
paradox	paradoxe
paradoxul	paradoxe
paralelă	parallèle
paralele	parallèles
paralel	parallèle
paralizia	paralysie
paralizie	paralysie
parametrii	paramètres
parametru	paramètre
paramilitară	paramilitaire
paramilitare	paramilitaires
parcuri	parcs
parcursă	parcourue
parfumuri	parfums
parlamentară	parlementaire
parlamentare	parlementaire
parlamentar	parlementaire
parlamentele	parlements
parlamentelor	parlements
parlament	parlement
parlamentul	parlement
parlamentului	parlement
partenere	partenaires
partenerii	partenaires
partenerilor	partenaires
parteneri	partenaires
partener	partenaire
parțiale	partielles
participante	participant
participanții	participants
participanți	participants
participă	participe
participa	participer
participarea	participation
participare	participation
participării	participation
participat	participé
participau	participaient
participe	participer
particulele	particules
particulelor	particules
particule	particules
partidele	partis
partide	partis
partid	parti
partidul	parti
pasagerii	passagers
pasagerilor	passagers
pasageri	passagers
pasager	passager
pasiunea	passion
pasiune	passion
pasivă	passive
pasiv	passive
paste	pâtes
patogene	pathogènes
patogen	pathogène
patriarhală	patriarcale
patriarhale	patriarcale
patriarhii	patriarches
patriarhului	patriarche
patrimoniul	patrimoine
patrimoniului	patrimoine
patrimoniu	patrimoine
patriotică	patriotique
patriotice	patriotique
patriotism	patriotisme
patriotismul	patriotisme
patriot	patriote
patrulare	patrouille
pauza	pause
pauză	pause
pauze	pauses
pedagog	pédagogue
pelerinaj	pèlerinage
pelerinajul	pèlerinage
penală	pénal
penale	pénale
penal	pénal
peninsula	péninsule
peninsulei	péninsule
penitenciar	pénitentiaire
pensie	pension
pensiilor	pensions
pensii	pension
percepția	perception
percepție	perception
perceput	perçu
performanța	performance
pericol	péril
periferie	périphérie
perimetrul	périmètre
perioada	période
perioadă	période
perioadele	périodes
perioade	période
periodică	périodique
periodice	périodiques
permanentă	permanente
permanente	permanentes
permitea	permettait
permite	permet
permit	permettent
persană	persane
persane	perse
persecutarea	persécution
persecutați	persécutés
persecutat	persécuté
persecuția	persécution
persecuție	persécution
persistă	persiste
persistentă	persistant
persistente	persistantes
persoana	personne
persoană	personne
persoanele	personnes
persoanelor	personnes
persoane	personnes
personajele	personnages
personaje	personnages
personală	personnel
personale	personnelles
personalitatea	personnalité
personalitate	personnalité
personalizate	personnalisés
personal	personnel
personalul	personnel
personalului	personnel
perspectiva	perspective
perspectivă	perspective
perspectivele	perspectives
perspective	perspectives
pesta	peste
petrolieră	pétrolière
petrolier	pétrolier
petrol	pétrole
petrolul	pétrole
pianistul	pianiste
pierde	perdre
pierd	perdent
pierdute	perdues
pietoni	piétons
pietrele	pierres
pilot	pilote
pionierii	pionniers
piramida	pyramide
piramidă	pyramide
piramidei	pyramide
pistă	piste
pitoresc	pittoresque
planeta	planète
planetă	planète
planetei	planète
planificarea	planification
planificare	planification
planificării	planification
planificată	planifiée
planta	planter
plantele	plantes
plantelor	plantes
plante	plantes
planuri	plans
plasmă	plasma
plastice	plastiques
platforma	plateforme
platformă	plateforme
platformei	plateforme
platformele	plateformes
platforme	plateforme
platină	platine
plauzibilă	plausible
plauzibil	plausible
plebiscit	plébiscite
poezie	poésie
polarizarea	polarisation
polarizare	polarisation
polar	polaire
polen	pollen
politică	politique
politice	politiques
politicieni	politiciens
politicii	politique
politicile	politiques
politici	politique
politic	politique
poliție	police
pompierii	pompiers
populară	populaire
populare	populaires
popularitatea	popularité
popularitate	popularité
populația	population
populației	population
populațiile	populations
populațiilor	populations
pornografice	pornographiques
portabile	portables
portal	portail
portalul	portail
portalului	portail
portaluri	portails
portavioane	porte-avions
portavion	porte-avions
portofoliul	portefeuille
portuar	portuaire
portugheză	portugaise
portugheze	portugaise
portughezi	portugais
portughez	portugais
porturi	ports
posesia	possession
posibilă	possible
posibilele	possibles
posibile	possibles
posibilitatea	possibilité
posibil	possible
potabilă	potable
potențialele	potentielles
potențiale	potentielles
potențial	potentiel
potențialul	potentiel
potențialului	potentiel
pozitivă	positive
pozitive	positives
pozitiv	positive
practică	pratique
practicate	pratiquées
practice	pratiques
practicile	pratiques
practic	pratique
pragmatică	pragmatique
pragmatic	pragmatique
precară	précaire
precare	précaire
precauție	précaution
precedat	précédant
precedent	précédent
precisă	précise
precise	précises
precis	précis
precursorii	précurseurs
precursorul	précurseur
predominantă	prédominante
predominante	dominantes
prefectul	préfet
preferențial	préférentiel
preliminară	préliminaire
preliminare	préliminaires
preliminar	préliminaire
preludiul	prélude
prelungite	prolongée
prematură	prématuré
prematur	prématuré
premise	prémisses
preocupă	préoccupe
preocupare	préoccupation
preocupărilor	préoccupations
preocupat	préoccupé
preparate	préparations
prerogativele	prérogatives
presiunea	pression
presiune	pression
presiunii	pression
presiuni	pression
prestigioasă	prestigieuse
prestigioase	prestigieuses
prestigios	prestigieuse
prestigiul	prestige
prestigiului	prestige
prestigiu	prestige
pretendenți	prétendants
pretext	prétexte
pretextul	prétexte
prevăzute	prévues
prevăzut	prévu
preveni	prévenir
prevenirea	prévenir
prevenire	prévention
prevenirii	prévenir
preventivă	préventive
preventive	préventive
preventiv	préventive
previziuni	prévisions
prezenta	présentera
prezentate	présentées
prezente	présentes
prezidențiale	présidentielle
prezidențial	présidentiel
prezintă	présente
prezinte	présenter
primară	primaire
primare	primaire
primar	primaire
primate	primates
primitivă	primitive
prim-ministrul	ministre
principala	principal
principală	principale
principalele	principales
principale	principales
principal	principalement
principalul	principal
principatelor	principautés
principat	principauté
principiile	principes
principiilor	principes
principii	principes
principiul	principe
principiului	principe
principiu	principe
prioritate	priorité
prioritățile	priorités
priorități	priorités
privată	privée
privați	privés
privatizarea	privatisation
privatizare	privatisation
privatizării	privatisation
privat	privé
privilegiată	privilégiée
privilegiate	privilégiées
privilegiat	privilégié
privilegiile	privilèges
privilegiilor	privilèges
privilegii	privilèges
privilegiul	privilège
privilegiu	privilège
prizonierii	prisonniers
prizonierilor	prisonniers
prizonieri	prisonniers
prizonier	prisonnier
prizonierul	prisonnier
probabile	probables
probabilitatea	probabilité
probabil	probablement
problemă	problème
problematică	problématique
problemei	problème
problemele	problèmes
problemelor	problèmes
probleme	problèmes
procedură	procédure
procedurii	procédure
procedurile	procédures
procedurilor	procédures
proceduri	procédure
procente	pourcentages
procent	pourcentage
procentul	pourcentage
procesele	procès
procese	procès
proces	processus
procesul	processus
procesului	processus
proclama	proclamer
proclamarea	proclamation
proclamată	proclamée
proclamat	proclamé
procurorii	procureurs
procurorilor	procureurs
procurori	procureurs
procuror	procureur
procurorul	procureur
procurorului	procureur
producă	produire
producătoare	producteurs
producătorii	producteurs
producătorilor	producteurs
producători	producteurs
producător	producteur
producătorul	producteur
producătorului	producteur
producea	produisaient
produce	produire
produc	produisent
producția	production
producției	production
producție	production
productivă	productive
productive	productives
productivitatea	productivité
productivitate	productivité
productivității	productivité
productiv	productive
proeminent	éminent
profesia	profession
profesie	profession
profesii	professions
profesională	professionnelle
profesionale	professionnelle
profesionalism	professionnalisme
profesional	professionnel
profesioniști	professionnels
profesionist	professionnalisme
profesori	professeurs
profesor	professeur
profesorul	professeur
profesorului	professeur
profitând	profitant
profită	profitent
profit	profiter
profiturile	profits
profituri	profits
profundă	profonde
profunde	profonde
profund	profond
programarea	programmation
programare	programmation
programatori	programmeurs
programele	programmes
programelor	programmes
programe	programmes
program	programme
programul	programme
programului	programme
progresele	progrès
progrese	progrès
progresiste	progressistes
progresivă	progressive
progresive	progressive
progresiv	progressif
progres	progrès
progresul	progrès
progresului	progrès
proiectează	projette
proiecte	projets
proiect	projet
proliferarea	prolifération
promise	promises
promite	promet
promoționale	promotionnels
promotorii	promoteurs
promotor	promoteur
promovând	promouvant
promova	promouvoir
promovarea	promouvoir
promovat	promu
promoveze	promouvoir
propagandă	propagande
propagandei	propagande
proporții	proportions
proporțională	proportionnelle
proporțional	proportionnel
proprietarii	propriétaires
proprietarilor	propriétaires
proprietar	propriétaire
proprietarul	propriétaire
proprietatea	propriété
proprietate	propriété
propriile	propres
proprii	propres
propulsie	propulsion
propune	propose
propun	proposent
propuse	proposées
propus	proposé
prosperă	prospère
prospere	prospère
prosperitatea	prospérité
prosperitate	prospérité
prosperității	prospérité
prosper	prospère
prostituate	prostituée
prostituția	prostitution
prostituție	prostitution
protecția	protection
protecție	protection
protectoare	protectrice
protectori	protecteurs
protector	protecteur
proteine	protéines
protejarea	protéger
protestantă	protestante
protestante	protestantes
protesta	protester
protestează	proteste
protestele	protestations
protestelor	protestations
protest	protester
protocoalele	protocoles
protocoale	protocoles
protocol	protocole
protocolul	protocole
protocolului	protocole
prototipul	prototype
proveneau	provenaient
proveni	provenir
provinciale	provinciales
provinciei	province
provincie	province
provinciile	provinces
provinciilor	provinces
provincii	provinces
provine	provient
provin	proviennent
provizorie	provisoire
provizorii	provisoires
provizoriu	provisoire
provoacă	provoque
provocând	provoquant
provoca	provoquer
provocatoare	provocateur
provocator	provocateur
provocat	provoqué
prudență	prudence
prudent	prudemment
psihiatrice	psychiatriques
psihiatriei	psychiatrie
psihiatru	psychiatre
psihologia	psychologie
psihologică	psychologique
psihologice	psychologique
psihologic	psychologique
publicând	publiant
publică	public
publica	publiera
publicarea	publication
publicată	publiée
publicate	publiées
publicațiile	publications
publicații	publications
publicat	publié
publice	publics
publicitare	publicitaires
publicitar	publicitaire
publicitatea	publicité
publicității	publicité
publicul	public
pulmonare	pulmonaires
pulmonar	poumon
punct	point
rabin	rabbin
radarul	radar
radarului	radar
radiațiile	radiations
radiații	radiation
radicală	radical
radicale	radicales
radical	radicale
radioactivă	radioactive
radioactive	radioactifs
radioactivitate	radioactivité
radioactiv	radioactif
rafinărie	raffinerie
rafinării	raffineries
ramificații	ramifications
rampă	rampes
rapidă	rapide
rapide	rapides
raportate	rapportés
raportor	rapporteur
rasială	raciale
rasiale	raciales
rasism	racisme
rasismul	racisme
rasiste	raciste
rasist	raciste
răspunde	répondre
ratificarea	ratification
ratificată	ratifiée
ratificat	ratifié
rațională	rationnelle
raționale	rationnelles
rațional	rationnel
reabilitarea	réhabilitation
reabilitare	réhabilitation
reactive	réactive
reactiv	réactif
reactor	réacteur
reală	réel
reale	réelle
realism	réalisme
realismul	réalisme
realistă	réaliste
realiste	réalistes
realist	réaliste
realitate	réalité
rebele	rebelles
rebelii	rebelles
rebelilor	rebelles
rebeliune	rébellion
rebel	rebelle
recensământul	recensement
recensăminte	recensements
recentă	récent
recente	récente
recent	récent
recesiune	récession
reciclare	recyclage
recoltă	récolte
recolte	récolte
recomandarea	recommandation
recomandă	recommande
recomandare	recommandation
recomandări	recommandations
recomandată	recommandée
recomandate	recommandées
recomandat	recommandé
recompensă	récompense
recompensa	récompenser
recompensat	récompensé
recompense	récompenses
reconcilierea	concilier
reconciliere	réconciliation
reconstituie	reconstitue
reconstituită	reconstituée
reconstituit	reconstitué
reconstrucție	reconstruction
reconstruiască	reconstruire
reconstruirea	reconstruire
reconstrui	reconstruire
reconstruite	reconstruites
recordul	record
recrutarea	recruter
recruta	recruter
recrutare	recrutement
recrutat	recruté
recruteze	recruter
recunoscute	reconnues
recupera	recouvrer
recupereze	recouvrer
recurentă	récurrent
reducerea	réduire
reducere	réduire
referendumul	référendum
referendumului	référendum
referent	référent
reflectând	reflétant
reflectă	reflète
reflecte	refléter
reformarea	réformer
reforma	réforme
reformă	réforme
reformate	réformée
reformator	réformateur
reformat	réformé
reformei	réforme
reformele	réformes
reformelor	réformes
reforme	réforme
reformeze	réformer
reformist	réformiste
refugiat	réfugié
refugieze	refuge
refugiu	refuge
refuzat	refusé
regenerabile	renouvelable
regimente	régiments
regim	régime
regimul	régime
regională	régional
regionale	régionale
regional	régional
registrele	registres
registre	registres
registrul	registre
registru	registre
regiune	région
reglementarea	réglementation
reglementa	réglementer
reglementare	réglementaire
reglementările	règlements
reglementărilor	réglementations
reglementări	règlements
reglementată	réglementé
regres	revers
regulamentele	règlements
regulamente	règlements
regulament	règlement
regulamentul	règlement
regulamentului	règlement
regulate	régulier
reintrodus	réintroduit
relansarea	relance
relațiilor	relations
relativ	relativement
religia	religion
religiei	religion
religie	religion
religiile	religions
religiilor	religions
religii	religions
religioasă	religion
religioase	religieuse
religios	religieux
reorganizarea	réorganiser
reorganizare	réorganiser
reorganizării	réorganisation
reorganizată	réorganisée
repararea	réparer
repara	réparer
reparații	réparations
repatrierea	rapatriement
repercusiuni	répercussions
represaliile	représailles
represalii	représailles
represiunea	répression
represiune	répression
represiunii	répression
reprezentanții	représentants
reprezentanților	représentants
reprezentanți	représentants
reprezentant	représentant
reprezentantul	représentant
reprezentarea	représentation
reprezenta	représenter
reprezentare	représentation
reprezentată	représentée
reprezentate	représentées
reprezentativă	représentative
reprezentative	représentative
reprezentativ	représentatif
reprezentat	représenté
reprezentau	représentaient
reprezinte	représenter
reprimarea	réprimer
reproducere	reproduction
republicane	républicaines
republicani	républicains
republican	républicain
republică	république
republicii	république
republicile	républiques
republici	république
reputația	réputation
reputație	réputation
rescrie	réécrire
respectă	respecte
respecta	respecter
respectată	respectée
respectate	respectées
respectat	respecté
respecte	respecter
respective	respectifs
respiratorii	respiratoires
respirator	respiratoire
responsabilă	responsable
responsabilitatea	responsabilité
responsabilitate	responsabilité
responsabil	responsable
restabilirea	rétablir
restabili	rétablir
restabilită	rétablie
restabilit	rétabli
restaurante	restaurants
restituirea	restitution
restricțiile	restrictions
restricțiilor	restrictions
restricții	restriction
restructurare	restructuration
restul	reste
resursele	ressources
resurse	ressources
retrage	retirer
retrase	retirés
retrospectivă	rétrospective
reunificarea	réunification
reuni	réunir
reuniți	réunis
reunit	réuni
reuniune	réunion
reuniuni	réunion
revendicat	revendiqué
revoltele	révoltes
revoluția	révolution
revoluție	révolution
revoluțiilor	révolutions
revoluții	révolutions
revoluționare	révolutionnaires
revoluționar	révolutionnaire
rezerve	réserve
rezidențiale	résidentielles
rezident	résident
rezistentă	résistante
rezistente	résistantes
reziste	résister
rezultatele	résultats
rezultate	résultats
rezultat	résultat
rezultatul	résultat
rigidă	rigide
rigide	rigides
rigid	rigide
riguroasă	rigoureuse
riguros	rigoureuse
riscul	risque
riscurile	risques
rituală	rituel
ritual	rituel
ritualuri	rituels
rivale	rivales
rivalii	rivaux
rivalitate	rivalité
rivalul	rival
rivalului	rival
robustă	robuste
rocă	roche
romană	romain
română	roumain
române	roumaines
roman	romain
român	roumain
romantică	romantique
romantice	romantique
romantismul	romantique
romanul	roman
rotația	rotation
rotundă	ronde
rotunde	rondes
rubrică	rubrique
rubrici	rubriques
ruinat	ruiné
ruinele	ruines
ruine	ruines
rurală	rural
rurale	rurales
rusă	russe
rusesc	russe
rusești	russes
rutină	routine
sabotaj	sabotage
sacră	sacrée
sacre	sacrées
sacrifică	sacrifie
sacrificat	sacrifié
sacrifice	sacrifier
sacrificiile	sacrifices
sacrificii	sacrifices
sacrificiul	sacrifice
sacrificiului	sacrifice
sacrificiu	sacrifice
sacru	sacré
salariile	salaires
salariilor	salaires
salarii	salaire
salariul	salaire
salariu	salaire
saloanele	salons
salvează	sauve
salveze	sauver
șampanie	champagne
sancțiuni	sanctions
sanitare	sanitaires
șantier	chantier
sârbă	serbe
sârbe	serbe
sârb	serbe
satelit	satellite
satirice	satiriques
scandal	scandale
scandalul	scandale
scandalului	scandale
scandaluri	scandales
scandinave	scandinaves
scandinav	scandinave
scenariile	scénarios
scenarii	scénarios
scenariul	scénario
scenariu	scénario
scenele	scènes
sceptici	sceptiques
scepticism	scepticisme
scepticismul	scepticisme
sceptic	sceptique
schelet	squelette
schismă	schisme
schizofrenie	schizophrénie
sclav	esclave
sclavia	esclavage
sclavie	esclavage
sclavi	esclaves
sclavii	esclaves
școlile	écoles
scrie	écrire
scris	écrit
scrise	écrites
scrupule	scrupules
sculptura	sculpture
secesiunea	sécession
secesiune	sécession
secesiunii	sécession
secole	siècles
secretariat	secrétariat
secretariatul	secrétariat
secretariatului	secrétariat
secretar	secrétaire
secretarul	secrétaire
secretă	secrète
secrete	secrets
secretul	secret
sectă	secte
secțiunea	section
secțiuni	sections
sectoare	secteurs
sector	secteur
sectorul	secteur
secundară	secondaire
secundare	secondaire
secundar	secondaire
secunde	secondes
securitatea	sécurité
segmente	segments
segmentul	segment
seismică	sismique
selectivă	sélective
selective	sélective
selectiv	sélective
semantică	sémantique
semantice	sémantique
semestrul	semestre
semestru	semestre
semiconductoare	semi-conducteurs
seminarii	séminaires
seminar	séminaire
semnal	signal
semnatari	signataires
semnificativă	significative
semnificative	significatives
semnificativ	significative
senator	sénateur
senatul	sénat
sensibilă	sensible
sensibile	sensibles
sensibilitatea	sensibilité
sensibilitate	sensibilité
sensibil	sensible
sentimentală	sentimentales
sentimentele	sentiments
sentimentelor	sentiments
sentimente	sentiments
sentimentul	sentiment
separă	sépare
separa	séparer
separate	séparées
separatistă	séparatiste
separatiste	séparatiste
separat	séparé
separe	séparer
septembrie	septembre
seră	serre
serverele	serveurs
serverul	serveur
serviciile	services
serviciilor	services
servicii	services
serviciul	service
serviciului	service
serviciu	service
servi	servir
servit	servi
sesiunea	session
sesiune	session
sesiunii	session
sesiuni	session
sexuală	sexuelle
sexuale	sexuelle
sexualitatea	sexualité
sexualitate	sexualité
sexual	sexuel
siciliană	sicilienne
sicilian	sicilienne
simbioză	symbiose
simbolică	symbolique
simbolice	symbolique
simbolic	symbolique
simbolismul	symbolisme
simbolizează	symbolise
simbol	symbole
simbolul	symbole
simbolurile	symboles
simetria	symétrie
simetrice	symétriques
simetrie	symétrie
similară	similaire
similare	similaires
similar	similaire
simpatie	sympathie
simplificarea	simplifier
simplificată	simplifiée
simplificate	simplifiée
simplificat	simplifié
simptome	symptômes
simptom	symptôme
simulează	simule
simultană	simultanée
simultane	simultanée
simultan	simultanément
sinagogă	synagogue
sinagogi	synagogue
sinceră	sincère
sinceritatea	sincérité
sinceritate	sincérité
sindicală	syndical
sindicale	syndicales
sindicatelor	syndicats
sindicate	syndicats
sindicat	syndicat
sindicatul	syndicat
sindromul	syndrome
sinonim	synonyme
sinucidă	suicide
sirenă	sirènes
sirian	syrien
sirieni	syriens
sistematică	systématique
sistematice	systématique
sistematic	systématique
sistem	système
situată	située
situate	situées
situația	situation
situație	situation
situații	situations
situat	situé
sloganul	slogan
slovacă	slovaque
slovace	slovaque
slovaci	slovaques
slovac	slovaque
slovenă	slovène
sloven	slovène
socială	sociale
social-democrații	sociaux-démocrates
social-democrat	social-démocrate
sociale	sociales
socialism	socialisme
socialismul	socialisme
socialismului	socialisme
socialistă	socialiste
socialiste	socialistes
socialiștii	socialistes
socialiști	socialistes
socialist	socialiste
socializare	socialisation
sociolog	sociologue
sodiu	sodium
sofisticate	sophistiquée
solare	solaire
solar	solaire
soldați	soldats
soldatul	soldat
soldatului	soldat
solemne	solennelles
solemn	solennel
solidaritatea	solidarité
solidaritate	solidarité
solidă	solide
solide	solides
solid	solide
soluție	solution
soluții	solutions
sondaje	sondages
sondaj	sondage
sovietică	soviétique
sovietice	soviétique
sovietic	soviétique
spaniolă	espagnole
spaniole	espagnole
spaniol	espagnol
spanioli	espagnols
spațială	spatiale
spațiale	spatiales
specială	spéciale
speciale	spéciale
specialiștilor	spécialistes
specialiști	spécialistes
specialist	spécialiste
specialitate	spécialisée
specializarea	spécialisation
specializare	spécialisation
specializată	spécialisé
specializate	spécialisées
specializat	spécialisé
specifică	spécifique
specificat	spécifié
specifice	spécifiques
specific	spécifique
spectacolelor	spectacles
spectacole	spectacles
spectacol	spectacle
spectacolul	spectacle
spectacolului	spectacle
spectaculoasă	spectaculaire
spectaculoase	spectaculaires
spectaculos	spectaculaire
spectator	spectateur
spectrul	spectre
spectru	spectre
speculațiile	spéculation
speculații	spéculation
speculativă	spéculative
spera	espérer
spionaj	espionnage
spionajul	espionnage
spirala	spirale
spirală	spirale
spirit	esprit
spiritualitate	spiritualité
spiritual	spirituel
spiritul	esprit
splendid	splendide
sponsori	sponsors
spontană	spontané
spontane	spontanées
spontan	spontané
sporadice	sporadiques
sporadic	sporadique
sportivă	sportive
sportive	sportives
sportivii	sportifs
sportivilor	sportifs
sportiv	sportive
sportul	sport
sportului	sport
stabilă	stable
stabile	stable
stabilește	établit
stabili	établir
stabilită	établie
stabilitatea	stabilité
stabilitate	stabilité
stabilității	stabilité
stabilite	établies
stabilit	établi
stabilizarea	stabiliser
stabilizat	stabilisé
stabil	stable
stagnare	stagnation
stalinismului	stalinisme
standardizată	standardisée
statică	statique
statice	statiques
static	statique
statistică	statistique
statistice	statistiques
statisticile	statistiques
statisticilor	statistiques
statistici	statistiques
statistic	statistique
statuie	statue
statuile	statues
statutul	statut
statutului	statut
stilistic	stylistique
stimularea	stimuler
stimulare	stimuler
stimula	stimuler
strategică	stratégique
strategice	stratégique
strategic	stratégique
strategiei	stratégie
strategie	stratégie
strategiile	stratégies
strategiilor	stratégies
strategii	stratégie
stres	stress
strict	stricte
structurală	structurel
structurale	structurelles
structural	structurel
structurarea	structurer
structura	structure
structură	structure
structurată	structurée
structurate	structurée
structurat	structuré
structurii	structure
structurile	structures
structurilor	structures
structuri	structure
studentă	étudiante
studia	étudier
studiate	étudiées
studiat	étudié
studieze	étudier
stupid	stupide
submarine	sous-marins
subordonarea	subordination
subordonare	subordonné
subordonată	subordonnée
subordonate	subordonnées
subordonat	subordonné
subsecretar	sous-secrétaire
substanțelor	substances
substanțe	substances
substanțială	substantielle
substanțial	substantielle
subterane	souterraine
subvenții	subventions
subzistență	subsistance
succedat	succédé
succesiunea	succession
succesiune	succession
succesiunii	succession
succesive	successives
succesoare	successeurs
succesorii	successeurs
succesor	successeur
succesorul	successeur
succesorului	successeur
succes	succès
sud-coreean	sud-coréen
sud-estul	sud-est
sud-vestul	sud-ouest
suferit	souffert
suficientă	suffisamment
suficiente	suffisantes
suficient	suffisamment
sugera	suggérer
sugerează	suggère
sugereze	suggérer
sugestie	suggestion
sugestii	suggestions
superficială	superficielle
superioritatea	supériorité
superioritate	supériorité
superior	supérieur
supermarket	supermarché
supleant	suppléant
suplimentare	supplémentaires
suplimentar	supplémentaire
supliment	supplément
suporte	supporter
suprarealistă	surréaliste
supraviețuirea	survie
supraviețui	survivre
supremă	suprême
suprem	suprême
surdă	sourde
surplusul	surplus
surprindă	surprendre
surprinderea	surprise
surprinde	surprend
surprins	surpris
surprize	surprises
suspectați	suspectés
suspectat	suspecté
suspecte	suspectes
suspendarea	suspendre
suverană	souveraine
suverane	souveraine
suveranitatea	souveraineté
suveranitate	souveraineté
suveranității	souveraineté
suveran	souverain
tabelele	tableaux
tabele	tableaux
tacit	tacite
tactica	tactique
tactică	tactique
tactice	tactiques
tacticile	tactiques
tactici	tactiques
tactic	tactique
talentele	talents
talente	talents
talentul	talent
tampon	tampons
tarife	tarifs
tehnică	technique
tehnice	techniques
tehnic	technique
tehnologia	technologie
tehnologică	technologique
tehnologice	technologique
tehnologic	technologique
tehnologiei	technologie
tehnologie	technologie
tehnologiile	technologies
tehnologiilor	technologies
tehnologii	technologies
telecomunicațiilor	télécommunications
telefonie	téléphonie
telegramă	télégramme
telespectatori	téléspectateurs
tematice	thématiques
temperat	tempéré
temperatură	température
temperaturii	température
temperaturile	températures
temperaturilor	températures
temperaturi	températures
templelor	temples
templul	temple
templului	temple
templu	temple
temporară	temporaire
temporare	temporaire
temporar	temporaire
tendința	tendance
tendință	tendance
tendințele	tendances
tendințe	tendances
tenis	tennis
tensiunea	tension
tensiune	tension
tensiunile	tensions
tensiunilor	tensions
tensiuni	tensions
teologie	théologie
teorie	théorie
teoriile	théories
terapeutică	thérapeutique
terapeutice	thérapeutiques
terapeutic	thérapeutique
terapie	thérapie
terapii	thérapies
teren	terrain
terenurile	terres
terestră	terrestre
terestre	terrestre
terestru	terrestre
teribilă	terrible
teribile	terribles
teribil	terrible
teritorială	territoriale
teritoriale	territoriale
teritoriile	territoires
teritoriilor	territoires
teritorii	territoires
teritoriul	territoire
teritoriu	territoire
termale	thermales
termeni	termes
termen	terme
termică	thermique
termice	thermique
terminale	terminaux
teroarea	terreur
teroare	terreur
terorism	terrorisme
terorismul	terrorisme
terorismului	terrorisme
teroristă	terroriste
teroriste	terroristes
terorist	terroriste
terțe	tiers
testamentul	testament
testată	testée
testa	tester
testate	testées
texte	textes
textile	textiles
textil	textile
tibetană	tibétain
tibetan	tibétain
tigrii	tigres
tigrului	tigre
tigru	tigre
timidă	timide
timid	timide
tirania	tyrannie
tiran	tyran
titularul	titulaire
toate	toutes
toleranța	tolérance
toleranță	tolérance
tolera	tolérer
tolerat	toléré
topografie	topographique
torturați	torturés
tortura	torture
tortură	torture
torturat	torturé
torturii	torture
totală	total
totale	totales
totalitarismului	totalitarisme
total	totalement
totalul	total
toxică	toxique
toxice	toxiques
toxicitatea	toxicité
toxicitate	toxicité
toxic	toxique
toxine	toxines
tractoare	tracteurs
tractor	tracteur
tradiția	tradition
tradiție	tradition
tradițiile	traditions
tradițiilor	traditions
tradiții	traditions
tradițională	traditionnelle
tradiționale	traditionnelles
tradițional	traditionnel
traducători	traducteurs
traducerea	traduction
traducere	traduction
traducerii	traduction
traducerilor	traductions
traduceri	traduction
traduse	traduits
traficul	trafic
traficului	trafic
tragediei	tragédie
tragedie	tragédie
tragedii	tragédie
tragică	tragique
tragice	tragiques
tragic	tragique
trambulină	tremplin
transatlantic	transatlantique
transferarea	transférer
transferată	transférée
transferate	transférées
transferă	transfère
transfera	transférer
transferat	transféré
transfere	transférer
transfer	transfert
transferul	transfert
transferului	transfert
transferurile	transferts
transformând	transformant
transformarea	transformer
transformare	transformation
transformării	transformation
transformările	transformations
transformărilor	transformations
transformări	transformations
transformată	transformée
transformate	transformés
transformă	transforme
transforma	transformer
transformat	transformé
transforme	transformer
transmisă	transmise
transmise	transmises
transmisie	transmission
transmită	transmettre
transmitere	transmission
transmite	transmettre
transparența	transparence
transparență	transparence
transparentă	transparente
transparente	transparentes
transparent	transparente
transplant	transplantation
transportată	transportée
transportate	transportées
transportă	transporte
transporta	transporter
transportat	transporté
transporte	transporter
transport	transports
transportul	transport
transportului	transport
transporturilor	transports
transpusă	transposée
transpus	transposé
transversală	transversal
transversale	transversales
tranzacție	transaction
tranziție	transition
tranzit	transit
tratamentele	traitements
tratamente	traitements
tratament	traitement
tratamentul	traitement
tratamentului	traitement
tratate	traitées
tratat	traité
tratează	traite
traversa	traverser
traversează	traverse
trezorier	trésorier
tribală	tribale
tribale	tribales
tribunalele	tribunaux
tribună	tribune
triburi	tribus
trimestru	trimestre
tripartit	tripartite
triplă	triple
triplu	triple
tristă	triste
triste	tristes
trist	triste
triunghiul	triangle
tropicală	tropicale
tropicale	tropicales
tropical	tropicaux
tropice	tropiques
trupele	troupes
trupelor	troupes
trupe	troupes
tuberculoza	tuberculose
tuberculozei	tuberculose
tunelului	tunnel
turbinele	turbines
turce	turque
turci	turcs
turism	tourisme
turismul	tourisme
turismului	tourisme
turistică	touristique
turistice	touristiques
turistic	touristique
turiști	touristes
turist	touriste
ucraineană	ukrainienne
ucrainean	ukrainien
ucrainene	ukrainienne
ucraineni	ukrainiens
umană	humain
umane	humaine
umanism	humanisme
umanistă	humaniste
umaniste	humaniste
umanist	humaniste
umanitară	humanitaire
umanitare	humanitaire
umanitar	humanitaire
umanitatea	humanité
umanitate	humanité
umanității	humanité
umbră	ombre
umbrele	ombres
umede	humide
umoristice	humoristique
unanimă	unanime
unanimitate	unanime
unanim	unanime
unice	unique
unificarea	unification
unificare	unification
unificării	unification
unificate	unifiée
unificat	unifié
uniforma	uniforme
uniformă	uniforme
uniforme	uniformes
uniform	uniforme
unilaterală	unilatérale
unilateral	unilatérale
unitare	unitaire
unitar	unitaire
unitate	unité
uniune	union
uniuni	union
universală	universelle
universale	universelle
universal	universel
universitară	universitaire
universitare	universitaires
universitar	universitaire
universitate	université
universități	universités
universul	univers
uragan	ouragan
uraganul	ouragan
uraniu	uranium
urbană	urbain
urbane	urbaine
urbanism	urbanisme
urban	urbain
urechile	oreilles
urgență	urgence
urgentă	urgent
urgent	urgence
utilă	utile
utile	utiles
utilitatea	utilité
utilitate	utilité
utilizând	utilisant
utilizare	utilisation
utilizată	utilisé
utilizate	utilisées
utilizatori	utilisateurs
utilizat	utilisé
utiliza	utiliser
utilizau	utilisaient
utilizează	utilise
utilizeze	utiliser
utopie	utopique
vacant	vacance
vacă	vache
vaccinarea	vaccination
vaccinare	vaccination
vaccinul	vaccin
vaccinurile	vaccins
vaccinuri	vaccins
vagoane	wagons
valabile	valables
valabilitate	validité
valea	vallée
validitatea	validité
valoare	valeur
valve	vanne
vândută	vendue
vândute	vendues
vândut	vendu
variabila	variable
variabilă	variable
variabilelor	variables
variabile	variables
variante	variantes
variată	variée
variațiilor	variation
variații	variations
variat	variait
varia	varier
variază	varie
varietate	variété
vasali	vassaux
vasal	vassal
vasculare	vasculaires
vegetală	végétale
vegetale	végétales
vegetarian	végétarien
vehicule	véhicules
vehicul	véhicule
venerabil	vénérable
verbale	verbales
verificarea	vérifier
verificare	vérification
verificat	vérifié
verifica	vérifier
verifice	vérifier
versiunea	version
versiune	version
versiunile	versions
versiuni	versions
verticală	verticale
verticale	verticales
vertical	verticalement
verzi	verte
veterinară	vétérinaire
veterinar	vétérinaire
victima	victime
victimă	victime
victimele	victimes
victimelor	victimes
victoria	victoire
victorie	victoire
victorii	victoires
victorioși	victorieux
video	vidéo
vietnameză	vietnamienne
vinde	vendre
violența	violence
violență	violence
violentă	violente
violenței	violence
violente	violentes
violent	violente
virală	virale
virgine	vierges
virgulă	virgule
virtuală	virtuel
virtuale	virtuelle
virtual	virtuel
virusului	virus
virusul	virus
vitală	vital
vitale	vitales
vitalitate	vitalité
vitaminei	vitamine
viticultură	viticole
vizibilă	visible
vizibile	visibles
vizibilitatea	visibilité
vizibilitate	visibilité
vizibil	visible
vizitat	visite
vizita	visite
vizită	visite
vizitei	visite
vizitele	visites
vizite	visite
viziteze	visiter
viziune	vision
viziuni	vision
vizuale	visuelle
vocabularului	vocabulaire
vocabularul	vocabulaire
volatile	volatils
volumele	volumes
volume	volumes
volumului	volume
volumul	volume
volum	volume
voluntară	volontaire
voluntare	volontaire
voluntariat	volontariat
voluntari	volontaires
voluntar	volontaire
votate	votées
votat	voté
voteze	voter
vulcanică	volcanique
vulcanice	volcanique
vulcanii	volcans
vulcanului	volcan
vulcanul	volcan
vulcan	volcan
vulgară	vulgaire
vulnerabilă	vulnérable
vulnerabile	vulnérables
vulnerabilitatea	vulnérabilité
vulnerabilitate	vulnérabilité
vulnerabil	vulnérable
