abandon	abbandono
abandonarea	abbandono
abandonată	abbandonata
abandonat	abbandonato
abandonate	abbandonate
abandonează	abbandona
abandoneze	abbandonare
abătut	abbattuta
abolită	abolita
abolit	abolita
abonament	abbonamento
abonamente	abbonamenti
abrogat	abrogato
absența	assente
absentă	assenza
absente	assenti
absoarbe	assorbe
absolută	assoluta
absolut	assolutamente
absorb	assorbono
absorbi	assorbire
absorbită	assorbita
absorbit	assorbita
absorbite	assorbite
abstractă	astratta
abstract	astratto
abstracte	astratte
absurdă	assurdo
absurd	assurdo
absurde	assurde
abundentă	abbondante
abuziv	abusivo
academică	accademica
academic	accademica
academice	accademiche
academie	accademia
academii	accademie
accelera	accelerare
accelerarea	accelerare
accelerat	accelerato
accelerează	accelera
accent	accento
accentul	accento
acceptă	accetta
accepta	accettare
acceptabilă	accettabile
acceptabil	accettabile
acceptabile	accettabili
acceptând	accettando
acceptarea	accettazione
acceptare	accettazione
acceptată	accettata
acceptat	accettato
acceptate	accettate
accepte	accettare
acces	accesso
accesibilă	accessibile
accesibil	accessibile
accesibile	accessibile
accesibilitate	accessibilità
accesorii	accessori
accesul	accesso
accident	accidentale
accidentală	accidentale
accidental	incidenti
accidente	incidenti
accidentele	incidente
accidentul	incidente
acide	acidi
acopere	coprire
acoperirea	coprire
acoperire	copertura
acoperită	coperta
acoperit	coperta
acoperite	coperte
acord	accordo
acordul	accordo
acorduri	accordi
acordurile	accordi
acreditat	accreditato
acționar	azionista
acționarii	azionisti
acțiune	azione
acțiuni	azioni
activă	attiva
activare	attivata
activată	attivato
activat	attivo
activ	attivazione
active	attive
activeze	attivare
activi	attivi
activist	attivista
activiștilor	attivisti
activitate	attività
activități	attività
activitățile	attività
actor	attore
actori	attori
actuala	attuale
actuală	attuale
actual	attuale
actuale	attuale
actualei	attuale
actualele	attuali
actualitate	attualità
acumulare	accumulo
acumulat	accumulati
acumulate	accumulati
acumulează	accumulano
adapta	adattare
adaptarea	adattare
adaptare	adattamento
adaptată	adattata
adaptat	adattati
adaptate	adattate
adapteze	adattare
adera	aderire
adere	aderire
adjectiv	aggettivo
administrarea	amministrazione
administrare	amministrazione
administrat	amministrato
administrate	amministrati
administrația	amministrazione
administrație	amministrazione
administrației	amministrazione
administrativă	amministrativa
administrativ	amministrativo
administrative	amministrative
admirat	ammirata
admirația	ammirazione
admirație	ammirazione
admise	ammesse
admisie	ammissione
admite	ammette
adolescenței	adolescenza
adolescenții	adolescenti
adoptă	adotta
adopta	adottare
adoptată	adottata
adoptat	adottata
adoptate	adottate
adopte	adottare
adopție	adozione
adriatică	adriatica
adultă	adulta
adult	adulto
adulter	adulterio
adulți	adulti
adversar	avversario
adversarii	avversari
adversarul	avversario
aerian	aerei
aeriene	aeree
aeronautică	aeronautica
aeroport	aeroporto
aeroportul	aeroporto
aeroportului	aeroportuale
aeroporturi	aeroporti
aeroporturile	aeroporti
aeroporturilor	aeroporti
afiliate	affiliate
afinitate	affinità
afirmă	afferma
afirma	affermare
afirmație	affermazione
afluenți	affluenti
afluenții	affluenti
africană	africana
african	africano
africane	africani
agenți	agenti
agenție	agenzia
agenții	agenzie
agențiile	agenzie
agentul	agente
agravat	aggravato
agresiunea	aggressione
agresiune	aggressione
agresiuni	aggressioni
agresiunii	aggressione
agresivă	aggressiva
agresiv	aggressiva
agresive	aggressive
agresivi	aggressivi
agresivitatea	aggressività
agresivitate	aggressività
agricolă	agricola
agricol	agricolo
agricole	agricola
agricultori	agricoltori
agricultorilor	agricoltori
agricultura	agricoltura
agricultură	agricoltura
agriculturii	agricoltura
alarmă	allarme
albaneză	albanese
albanez	albanese
albaneze	albanese
albanezi	albanesi
alcool	alcol
alcoolice	alcoliche
alcoolul	alcol
alcoolului	alcol
alertă	allerta
algebrică	algebrica
algele	alghe
algerian	algerino
algoritm	algoritmo
alianțe	alleanze
aliat	alleato
aliate	alleate
alimentară	alimentare
alimentar	alimentare
alimentare	alimentari
alimentată	alimentata
alimentat	alimentato
alimentate	alimentati
alimentație	alimentazione
alimente	alimentare
alimentează	alimenta
alimentele	alimenti
alimentelor	alimentari
alpină	alpina
alpine	alpino
alternativa	alternativa
alternativă	alternativa
alternative	alternativa
aluminiu	alluminio
aluviuni	alluvionali
amară	amara
amator	amatoriale
amatori	amatoriale
ambasada	ambasciata
ambasade	ambasciate
ambasador	ambasciatore
ambasadori	ambasciatori
ambasadorii	ambasciatori
ambasadorilor	ambasciatori
ambasadorul	ambasciatore
ambasadorului	ambasciatore
ambiguu	ambigua
ambiția	ambizione
ambiție	ambizione
ambițioasă	ambiziosa
ambițioase	ambiziosa
ambițios	ambizioso
amendamente	emendamento
amendament	emendamenti
americană	americana
american	americano
americane	americana
amfibii	anfibi
amnistie	amnistia
amonte	monte
amprenta	impronta
amprentă	impronta
amprente	impronte
analist	analista
analiști	analisti
analitice	analitiche
analize	analisi
anarhie	anarchia
ancestrale	ancestrali
ancorat	ancorato
anecdote	aneddoti
anglo-saxone	anglosassoni
animală	animale
animale	animali
animalele	animali
animalelor	animale
animată	animato
animate	animati
aniversarea	anniversario
aniversare	anniversario
aniversării	anniversario
anomalii	anomalie
anonimă	anonimo
anonime	anonimi
anormală	anomala
antenele	antenne
antibiotice	antibiotici
antică	antica
anticipând	anticipando
anticipat	anticipato
anticomunistă	anticomunista
anticomunist	anticomunista
anticomuniste	anticomunista
antidot	antidoto
antisemit	antisemita
antisemitism	antisemitismo
antisemitismului	antisemitismo
antrenament	addestramento
anual	annuale
anuale	annuale
anuar	annuario
anula	annullare
anulată	annullata
anulat	annullato
anuleze	annullare
aparatul	apparato
aparenta	apparente
aparentă	apparente
aparent	apparentemente
aparente	apparenti
apartament	appartamento
apartamente	appartamenti
apartenență	appartenenza
aparținea	apparteneva
aparține	appartiene
apelul	appello
apeluri	appelli
aplicabilă	applicabile
aplicabile	applicabile
aplicații	applicazioni
aplicațiile	applicazioni
aplicațiilor	applicazioni
aplice	applicare
apreciat	apprezzato
apreciază	apprezza
aprecieze	apprezzare
aprilie	aprile
aprobare	approvazione
aprobe	approvare
aprofundarea	approfondimento
aprofundate	approfondite
aprovizionarea	approvvigionamenti
aprovizionare	approvvigionamento
aproximativă	approssimativa
arabă	arabo
arabe	araba
arbitraj	arbitrale
arbitrară	arbitraria
arbitrar	arbitraria
arbitrare	arbitraria
arbitrii	arbitri
arbitru	arbitro
arbitrul	arbitro
arctică	artica
arctic	artico
arctice	artica
arenă	arena
arestări	arresti
arestării	arresto
argentiniană	argentina
argentinian	argentino
argentiniene	argentine
argumente	argomentazioni
arhaice	arcaica
arheologică	archeologica
arheologic	archeologico
arheologice	archeologici
arhipelag	arcipelago
arhipelagul	arcipelago
arhitect	architetto
arhitectonice	architettonica
arhitectura	architettura
arhitectură	architettura
arhitecturi	architettura
arhitecturii	architettura
arhivă	archivio
arhive	archivi
arhivele	archivi
arhivelor	archivi
aritmetică	aritmetica
armament	armamenti
armat	armato
armate	armati
armenii	armeni
armonia	armonia
armonie	armonia
armoniei	armonia
armonios	armonico
aromatice	aromatici
arsenal	arsenale
arsenalul	arsenale
artă	arte
arterele	arterie
arterială	arteriosa
articol	articolo
articole	articoli
articolele	articoli
articolelor	articoli
articolul	articolo
articolului	articolo
articulate	articolati
artificială	artificiale
artificial	artificiale
artificiale	artificiali
artilerie	artiglieria
artileriei	artiglieria
artist	artista
artiști	artisti
artistică	artistica
artistic	artistico
artiștii	artisti
artistul	artista
artizanale	artigianali
artizanat	artigiane
asamblate	assemblate
asasinarea	assassinio
asasinare	assassinio
asasin	assassino
asasinat	assassinato
asasini	assassini
asasinii	assassini
asiatică	asiatica
asiatic	asiatico
asiatice	asiatiche
asigurând	assicurando
asigurare	assicurazione
asimetric	asimmetrica
asimetrice	asimmetriche
asimilare	assimilazione
asimilat	assimilato
asirieni	assiri
asistă	assiste
asista	assistere
asistat	assistito
asistență	assistente
asistenta	assistenza
asistent	assistente
asistentul	assistente
asociată	associata
asociat	associato
asociate	associate
asociație	associazione
asociații	associazioni
asociațiile	associazioni
asociațiilor	associazioni
asociază	associano
asocierea	associare
aspecte	aspetti
aspectele	aspetti
aspiră	aspira
aspirația	aspirazione
aspirație	aspirazione
aspirații	aspirazioni
aspirațiile	aspirazioni
astronaut	astronauta
astronomică	astronomica
astronomice	astronomica
asumă	assume
asuma	assumerà
asume	assumere
atacurile	attacchi
atentă	attenta
atenție	attenzione
atenuarea	attenuare
atlantice	atlantiche
atmosfera	atmosfera
atmosferă	atmosfera
atmosferei	atmosfera
atmosferice	atmosferiche
atomică	atomica
atomice	atomiche
atractiv	attraente
atribuită	attribuita
atribuite	attribuite
atribut	attributo
atribute	attributi
atributele	attributi
atributul	attributo
atrocități	atrocità
atrocitățile	atrocità
audiență	audience
auspiciile	auspici
australian	australiano
australiene	australiani
austriac	austriaco
austriece	austriache
austrieci	austriaci
austro-ungară	austro-ungarico
austro-ungare	austro-ungarico
autentic	autentico
autentice	autentiche
autenticitatea	autenticità
autoare	autore
autobuzul	autobus
autocamioane	camion
autohtonă	autoctona
autohtone	autoctone
automată	automatica
automat	automatico
automate	automatiche
automobile	automobili
automobilelor	automobilistico
autonomă	autonoma
autonom	autonomo
autonome	autonomi
autonomia	autonomia
autonomie	autonomia
autonomiei	autonomia
autor	autore
autoritară	autoritaria
autoritar	autoritario
autoritatea	autorità
autoritate	autorità
autorității	autorità
autoritățile	autorità
autorităților	autorità
autorizarea	autorizzazione
autorizată	autorizzata
autorizate	autorizzate
autorizează	autorizza
autovehicule	autoveicoli
auxiliară	ausiliaria
auxiliare	ausiliarie
avangarda	avanguardia
avanpost	avamposto
avansat	avanzata
avansate	avanzate
avantaje	vantaggiosa
avantajoasă	vantaggioso
avantajos	vantaggio
avantaj	vantaggi
aventură	avventura
aventurile	avventure
avertisment	avvertimento
avocați	avvocati
avocaților	avvocati
avocatului	avvocato
bacterie	batterio
bacterii	batteri
bacteriile	batterio
bacteriilor	batteri
bagajele	bagagli
balene	balena
balistice	balistici
baltice	baltici
banal	banale
bancară	bancaria
bancar	bancario
bancare	bancarie
bancher	banchiere
banchet	banchetto
bandă	banda
barbar	barbara
barbare	barbara
bariere	barriere
barierele	barriere
baronilor	baroni
baterii	batteria
bateriile	batterie
bateriilor	batterie
bavarez	bavarese
belarus	bielorusso
belgiană	belga
belgian	belga
belgiene	belga
belgieni	belgi
beneficia	beneficiare
beneficiar	beneficiario
beneficiat	beneficiato
beneficieze	beneficiare
beneficiile	benefici
beneficiu	beneficio
biblia	bibbia
biblic	biblico
biblice	bibliche
bibliotecă	biblioteca
biblioteci	biblioteca
bibliotecii	biblioteca
bibliotecile	biblioteche
bicicletă	bicicletta
biciclete	biciclette
bilaterale	bilaterali
bilet	biglietto
bilete	biglietti
biletele	biglietti
bilingvă	bilingue
bilingv	bilingue
bilingve	bilingue
biochimice	biochimico
biodiversitate	biodiversità
biodiversității	biodiversità
biografii	biografia
biologic	biologico
biologice	biologiche
biotehnologie	biotecnologie
bizar	bizzarra
bizare	bizzarre
blocarea	bloccare
blocuri	blocchi
boicot	boicottaggio
bombă	bomba
bombardament	bombardamenti
bombardamente	bombardamenti
bombardamentele	bombardamenti
bombardamentelor	bombardamenti
bombardarea	bombardamento
bombardată	bombardata
bombardat	bombardata
bombele	bombe
bosniacă	bosniaca
bosniac	bosniaco
bovine	bovini
bovinelor	bovino
brazilian	brasiliano
braziliene	brasiliane
brazilieni	brasiliani
brevete	brevetti
brevetul	brevetto
brigada	brigata
britanică	britannica
britanic	britannico
britanice	britanniche
britanici	britannici
brută	bruta
brutală	brutale
brutal	brutale
brutale	brutali
brutalitate	brutalità
budismului	buddismo
budistă	buddista
budist	buddista
bulgară	bulgara
bulgar	bulgaro
bulgare	bulgara
burgheze	borghesi
burghezia	borghesia
burgheziei	borghesia
bursă	borsa
burse	borse
bustul	busto
buton	bottone
cabină	cabina
cabinetul	gabinetto
cabinetului	gabinetto
cadastru	catasto
cadavre	cadaveri
cafea	caffè
calcula	calcolare
calcularea	calcolo
calculată	calcolata
calculat	calcolato
calculate	calcolate
calcule	calcoli
calculele	calcoli
calculelor	calcoli
calculul	calcolo
caldă	caldo
calendar	calendario
calendare	calendari
calendarul	calendario
calendarului	calendario
calibru	calibro
calificare	qualifica
calificate	qualificate
calitativă	qualitativa
calitative	qualitativa
calitativ	qualitativo
calmă	calma
calmul	calma
camerele	camere
camioane	camion
campania	campagna
campanie	campagna
campaniei	campagna
campanii	campagna
campaniile	campagne
campaniilor	campagne
campioană	campione
campionatele	campionati
campionatul	campionato
campionii	campioni
campionul	campione
campusul	campus
canadiană	canadese
canadian	canadese
canadiene	canadese
canadieni	canadesi
canale	canali
canalizarea	incanalare
canalul	canale
cancelar	cancelliere
cancelarului	cancelliere
cancer	cancro
cancerul	cancro
cancerului	cancro
candidate	candidati
candidați	candidati
candidatul	candidato
candidatului	candidato
candidaturii	candidatura
canonică	canonico
canonic	canonico
canonice	canonico
cantitativă	quantitativa
cantitative	quantitativi
cantitativ	quantitativa
cantonul	cantone
capabil	capace
capabile	capaci
capabili	capaci
capacitatea	capacità
capacitate	capacità
capacității	capacità
capitala	capitale
capitală	capitale
capital	capitale
capitale	capitali
capitalele	capitali
capitalism	capitalismo
capitalismul	capitalismo
capitalismului	capitalismo
capitalistă	capitalista
capitalist	capitalista
capitaliste	capitalista
capitalul	capitale
capitalului	capitali
căpitan	capitano
căpitanul	capitano
căpitanului	capitano
capitol	capitolo
capitole	capitoli
capitolele	capitoli
capitolul	capitolo
capitulare	capitolazione
captarea	cattura
captivitate	cattività
captură	cattura
capturarea	catturare
capturat	catturato
captureze	catturare
caracteristică	caratteristica
caracteristici	caratteristiche
caracteristicile	caratteristiche
caracteristicilor	caratteristiche
caracterizată	caratterizzata
caracterizat	caratterizzato
caracterizate	caratterizzate
caracterizează	caratterizza
caracterul	carattere
carantină	quarantena
carbon	carbonio
carcasa	carcasse
cardiacă	cardiaca
cardiac	cardiaco
cardiace	cardiache
caricatură	caricatura
cariere	carriere
carierei	carriera
caritate	carità
cartezian	cartesiano
cartierele	quartieri
cartierelor	quartieri
cartiere	quartieri
cartier	quartier
carul	carro
castă	casta
catalana	catalana
catalană	catalano
catalane	catalana
catalog	catalogo
catalogul	catalogo
catastrofă	catastrofe
catastrofală	catastrofica
catastrofe	catastrofi
catedrala	cattedrale
catedralei	cattedrale
categorie	categoria
categorii	categoria
categoriile	categorie
categoriilor	categorie
catolică	cattolica
catolic	cattolico
catolice	cattoliche
catolici	cattolici
catolicii	cattolici
catolicismul	cattolicesimo
cauza	causa
cauze	cause
cauzele	cause
cazinou	casinò
cehoslovac	cecoslovacco
celtic	celtica
celula	cellula
celulă	cellula
celule	cellule
celulele	cellule
celulelor	cellule
centenarul	centenario
centrală	centrale
centrale	centrali
centralele	centrali
centralizată	centralizzata
centralizat	centralizzato
centralizate	centralizzata
centrată	centrata
centre	centri
centrele	centri
centrelor	centri
centru	centro
centru-dreapta	centro-destra
centrul	centro
centurile	cinture
cenzura	censura
cenzură	censura
cenzurat	censurata
cenzurii	censura
cercetător	ricercatore
cercul	cerchia
cereale	cereali
cerealele	cereali
cerebrală	cerebrale
cerebrale	cerebrali
ceremonia	cerimonia
ceremonie	cerimonia
certificarea	certificazione
certificare	certificazione
certificat	certificato
certificate	certificati
certificatul	certificato
certitudinea	certezza
chilian	cileno
chimică	chimica
chimic	chimica
chimice	chimiche
chimiei	chimica
chimist	chimico
chineză	cinese
chinez	cinese
chineze	cinesi
chinezi	cinesi
chirurg	chirurgo
chirurgicale	chirurgia
cianură	cianuro
cicliști	ciclisti
ciclu	ciclo
cifră	cifra
cifrele	cifre
cilindrică	cilindrata
cimentului	cemento
cimitir	cimitero
cimitire	cimiteri
cimitirul	cimitero
cinematografică	cinematografica
ciocolată	cioccolato
cipriotă	cipriota
circuitele	circuiti
circuitelor	circuiti
circuitul	circuito
circulă	circola
circula	circolare
circulară	circolare
circulație	circolazione
circul	circo
circule	circolare
circumscripția	circoscrizione
circumscripții	circoscrizioni
circumstanțe	circostanze
citadelă	cittadella
citat	citando
citează	citano
civică	civica
civic	civico
civice	civiche
civilă	civile
civile	civili
civililor	civili
clare	chiare
clarificarea	chiarire
clasa	classe
clasă	classe
clase	classi
clasei	classe
clasele	classi
clasică	classica
clasic	classico
clasice	classiche
clasificarea	classificare
clasificare	classificazione
clasificări	classificazioni
clasificării	classificazione
clauza	clausola
clauze	clausole
clerici	clero
clienți	clienti
clienții	clienti
clienților	clienti
clientul	cliente
clientului	cliente
climă	clima
climatice	climatici
climei	clima
clinică	clinica
clinic	clinico
clinice	cliniche
clinici	cliniche
clone	cloni
clorură	cloruro
coaliție	coalizione
coarne	corna
coautor	coautore
cocaină	cocaina
codificarea	codificare
codificare	codificazione
codificat	codificato
coerentă	coerente
coerent	coerente
coerente	coerenti
cognitivă	cognitivo
cognitive	cognitivi
coincid	coincidono
coincidență	coincidenza
colaborarea	collaborazione
colaborare	collaborazione
colaborat	collaborato
colaborator	collaboratore
colaboreze	collaborare
colaterale	collaterali
colectivă	collettiva
colectiv	collettiva
colective	collettive
colegul	collega
colegului	collega
colesterol	colesterolo
coliziune	collisione
coloana	colonna
colonelul	colonnello
colonială	coloniale
coloniale	coloniali
colonii	colonie
coloniilor	colonie
colonizarea	colonizzazione
colonizare	colonizzazione
colonizării	colonizzazione
colonizată	colonizzata
colorat	colorato
columbian	colombiano
comanda	comando
comandant	comandante
comandantul	comandante
comandantului	comandante
comandate	commissionate
combat	combattono
combate	combattere
combatere	combattere
combătut	combattuta
combina	combinare
combinând	combinando
combinarea	combinazione
combinată	combinata
combinat	combinato
combinație	combinazione
combine	combinare
combustibil	combustibile
combustibililor	combustibili
combustibilul	combustibile
combustibilului	combustibile
comemora	commemorare
comemorarea	commemorare
comemorare	commemorazione
comemorat	commemorato
comemorativă	commemorativa
comemorează	commemora
comentarii	commenti
comentariile	commenti
comentariu	commento
comentat	commentato
comentator	commentatore
comentatori	commentatori
comercială	commerciale
comercial	commerciale
comerciale	commerciali
comercializarea	commercializzazione
comercializare	commercializzazione
comercializării	commercializzazione
comercializat	commercializzato
comercializate	commercializzati
comerciant	commerciante
comercianți	commercianti
comercianții	commercianti
comerț	commercio
comerțul	commercio
comestibil	commestibile
comestibile	commestibili
comisari	commissari
comisarilor	commissari
comisarul	commissario
comisarului	commissario
comis	commesso
comise	commesse
comisiei	commissione
comisiile	commissioni
comisiilor	commissioni
comite	commette
comiterea	commettere
comitet	comitato
comitete	comitati
comitetul	comitato
comitetului	comitato
companie	compagnia
companiile	compagnie
companiilor	compagnie
comparabilă	comparabile
comparabile	comparabili
compararea	comparazione
comparat	comparato
comparativă	comparativa
compasiune	compassione
compatibilă	compatibile
compatibil	compatibile
compatibile	compatibili
compatibilitatea	compatibilità
compatibilitate	compatibilità
compendiu	compendio
compensa	compensare
compensare	compensazione
competența	competente
competentă	competenza
competență	competenza
competent	competente
competențe	competenti
competente	competenze
competențele	competenze
competitiv	competitivo
competitive	competitivi
complementară	complementare
complementar	complementare
complementare	complementari
completă	completa
completare	complemento
completată	completata
completat	completato
complet	completamente
complete	completi
completeze	completare
complexă	complessa
complex	complessa
complexe	complesse
complexitatea	complessità
complexitate	complessità
complică	complica
complicată	complicata
complicat	complicata
complicate	complicati
complicații	complicazioni
complice	complicare
complicitate	complicità
componenta	componente
componentă	componente
componente	componenti
componentele	componenti
componentelor	componenti
comportamentală	comportamentale
comportament	comportamenti
comportamente	comportamenti
comportamentul	comportamenti
comportamentului	comportamenti
comporte	comportarsi
compozitorilor	compositori
compozitorul	compositore
compromisul	compromesso
compromisuri	compromessi
compromite	compromettere
compun	compongono
compus	composto
comună	comune
comun	comune
comune	comuni
comunică	comunicano
comunica	comunicare
comunicarea	comunicazione
comunicare	comunicazione
comunicări	comunicazioni
comunicării	comunicazione
comunicat	comunicato
comunicațiile	comunicazioni
comunice	comunicare
comunism	comunismo
comunismul	comunismo
comunismului	comunismo
comunistă	comunista
comunist	comunista
comuniste	comunista
comunitară	comunitaria
comunitar	comunitario
comunitare	comunitarie
comunitatea	comunità
comunitate	comunità
concentra	concentrare
concentrându-se	concentrandosi
concentrată	concentrata
concentrat	concentrata
concentrate	incentrate
concentrații	concentrazioni
concentrează	concentra
concentreze	concentrare
concepte	concetti
conceptele	concetti
conceptelor	concetti
conceptuală	concettuale
conceptual	concettuale
conceptul	concetto
conceptului	concetto
conceput	concepito
concepute	concepite
concesii	concessioni
concluzia	conclusione
concluzie	conclusione
concluzii	conclusioni
concluziile	conclusioni
concretă	concreta
concret	concreta
concrete	concreti
concurența	concorrenza
concurență	concorrenza
concurent	concorrente
concurente	concorrenti
concurenței	concorrenza
concurenții	concorrenti
concurenților	concorrenti
concurs	concorso
concursul	concorso
condamnă	condanna
condamna	condannare
condamnarea	condanna
condamnare	condanna
condamnată	condannata
condamnat	condannato
condamnate	condannate
condamnați	condannati
condiția	condizione
condiție	condizione
condiții	condizioni
condițiile	condizioni
conduită	condotta
conectivitate	connettività
conexiuni	connessioni
conexiunile	connessioni
conferă	conferisce
conferință	conferenza
conferințele	conferenze
conferit	conferito
confesiuni	confessioni
confirma	conferma
confirmă	confermare
confirmând	confermando
confirmarea	conferma
confirmare	conferma
confirmată	confermata
confirmat	confermato
confirmate	confermate
confirme	confermare
confiscarea	confisca
confiscate	confiscati
conflict	conflitto
conflicte	conflitti
conflictele	conflitti
conflictelor	conflitti
conflictul	conflitto
conflictului	conflitto
conforme	conformi
conformitate	conformità
confortabilă	confortevole
confortul	comfort
confruntare	confronto
confruntările	scontri
confruntări	scontri
confundă	confonde
confundată	confusa
confundat	confuso
confundate	confuse
confuză	confusa
confuzia	confusione
confuzie	confusione
confuzii	confusione
conglomerat	conglomerato
congregații	congregazioni
congresul	congresso
conotații	connotati
consecutivă	consecutiva
consecutiv	consecutiva
consens	consenso
consensul	consenso
conservarea	conservazione
conservării	conservazione
conservatoare	conservatori
conservator	conservatore
conservatorii	conservatori
conservatorilor	conservatori
conserve	conserva
considerabilă	considerevole
considerabil	considerevole
considerabile	considerevoli
consideră	considera
considerăm	consideriamo
considerare	considerazione
considerată	considerata
considerat	considerato
considerate	considerati
considerente	considerazioni
consilier	consigliere
consiliere	consulenza
consilieri	consiglieri
consilierii	consiglieri
consilierilor	consiglieri
consilii	consigli
consiliile	consigli
consiliilor	consigli
consiliu	consiglio
consiliul	consiglio
consiliului	consiglio
consolida	consolidare
consolidarea	consolidamento
consolidare	consolidamento
consolidării	consolidamento
consolidată	consolidata
consolidat	consolidato
consolideze	consolidare
conspirație	cospirazione
conspiratorii	cospiratori
constă	consiste
constantă	costante
constant	costante
constante	costanti
constatat	constatato
constitui	costituirà
constituie	costituisce
constituite	costituiti
constituțională	costituzionale
constituțional	costituzionale
constituționale	costituzionali
constructivă	costruttiva
constructiv	costruttivo
construiască	costruire
construi	costruire
construiesc	costruendo
construiește	costruisce
construind	costruendo
construirea	costruire
construită	costruita
construite	costruite
consulare	consolare
consulatul	consolato
consulta	consultare
consultanți	consulenti
consultarea	consultazione
consultare	consultazione
consultat	consultato
consultativ	consultivo
consulte	consultare
consulul	console
consumă	consuma
consuma	consumare
consumat	consumato
consumator	consumatore
consumatorii	consumatori
consumatorilor	consumatori
consumatorului	consumatore
consume	consumare
contabil	contabile
contabile	contabili
contabilitatea	contabilità
contabilitate	contabilità
contactat	contattato
contact	contatto
contacte	contatti
contactele	contatti
contactelor	contatti
contacteze	contattare
contactul	contatti
containere	container
contaminarea	contaminazione
contaminare	contaminazione
contaminate	contaminati
contele	conte
contemporană	contemporanea
contemporan	contemporaneo
contemporane	contemporanea
contemporanilor	contemporanei
contestă	contesta
contestată	contestata
contestat	contestato
context	contesto
contexte	contesti
contextul	contesto
conținea	conteneva
conține	contiene
continentală	continentale
continental	continentale
continentale	continentali
continente	continenti
continentul	continente
continentului	continente
continuă	continua
continua	continuare
continuând	continuando
continuat	continuato
continue	continuare
continuitatea	continuità
continuitate	continuità
conținutul	contenuti
continuu	continuo
contraatac	contrattacco
contraatacul	contrattacco
contraatacuri	contrattacchi
contrabandă	contrabbando
contract	contratto
contracte	contratti
contractele	contratti
contractelor	contratti
contractuale	contrattuali
contractului	contratto
contradicții	contraddizioni
contradicțiile	contraddizioni
contradictorii	contraddittorie
contradictoriu	contraddittorio
contrar	contrariamente
contrare	contrarie
contraspionaj	controspionaggio
contrastează	contrasta
contrazice	contraddizione
contribui	contribuire
contribuie	contribuire
contribuind	contribuendo
contribuit	contribuito
contribuția	contributo
contribuție	contributo
contribuții	contributi
contribuțiile	contributi
contribuțiilor	contributi
controla	controllare
controlată	controllata
controlat	controllata
controlate	controllate
control	controllo
controlează	controlla
controleze	controllare
controlul	controllo
controversată	controversa
controversat	controversa
controversate	controverse
contumacie	contumacia
convenit	convenuto
convenții	convenzioni
convențiile	convenzioni
convențiilor	convenzioni
convențional	convenzionale
convergența	convergente
convergență	convergenza
conversații	conversazione
conversia	conversione
conversie	conversione
convingă	convincere
convingătoare	convince
convingător	convincente
convinge	convincere
convingere	convinzione
convinsă	convinta
convins	convinto
convinși	convinti
convocarea	convocare
convocat	convocato
convoiul	convoglio
cooperare	cooperazione
coopereze	cooperare
coordona	coordinare
coordonarea	coordinamento
coordonare	coordinamento
coordonată	coordinata
coordonat	coordinata
coordonate	coordinate
coordonator	coordinatore
coordonatorul	coordinatore
coordonează	coordina
coordoneze	coordinare
copiată	copiato
copieze	copiare
copiile	copie
coptă	copta
coral	corallo
coralilor	corallo
cordonul	cordone
corectă	corretta
corect	corretta
corecte	corrette
corecție	correzione
coreeană	coreana
coreean	coreano
coreene	coreana
coreeni	coreani
corespondența	corrispondenza
corespondență	corrispondenza
corespundă	corrispondere
corespund	corrispondono
corespundea	corrispondeva
corespunde	corrisponde
coridoare	corridoi
coridor	corridoio
coridorul	corridoio
coroană	corona
coroane	corone
corporală	corporale
corpul	corpo
corupție	corruzione
corupției	corruzione
cosmetice	cosmetici
cosmopolit	cosmopolita
costă	costa
costul	costo
costum	costume
cotate	quotate
crearea	creare
creativă	creativa
creativ	creativa
creative	creativa
creativitatea	creatività
creativitate	creatività
creativității	creatività
creator	creatore
creatură	creatura
creaturi	creature
credibilă	credibile
credibile	attendibili
credibilitatea	credibilità
credibilitate	credibilità
credit	credito
credite	crediti
creditele	crediti
creditelor	credito
creștin	cristiano
creștine	cristiane
creștini	cristiani
crima	crimine
crimă	crimine
crime	crimini
crimei	crimine
criminal	criminale
criminale	criminali
criterii	criteri
criteriile	criteri
criteriu	criterio
criteriul	criterio
critică	critica
critica	criticare
criticat	criticato
criticate	criticati
critic	critica
critice	critiche
critici	critica
criticile	critiche
criza	crisi
criză	crisi
crize	crisi
crizei	crisi
croat	croato
croate	croata
croați	croati
crocodil	coccodrillo
cromatică	cromatica
cromozomilor	cromosomi
cronică	cronica
cronice	croniche
cronologică	cronologico
cruciada	crociata
cruciadă	crociata
cruciade	crociate
crucială	cruciale
cruci	croci
crudă	crudele
crude	crudele
crustacee	crostacei
cubanez	cubano
cubaneze	cubana
culminat	culminata
cultelor	culto
cultivă	coltiva
cultiva	coltivare
cultivată	coltivato
cultură	cultura
culturală	culturale
cultural	culturale
culturale	culturali
culturi	culture
culturii	cultura
culturile	culture
culturilor	culture
cuprinde	comprende
curba	curva
curbe	curva
curbura	curvatura
curent	corrente
curios	curioso
curiozitate	curiosità
cursa	corsa
cursă	corsa
curse	corsa
cursele	corse
danezi	danesi
debarce	sbarcare
decembrie	dicembre
decenii	decenni
deceniu	decennio
deces	decesso
decidă	decidere
decid	decide
decide	deciderà
decise	decisi
decisivă	decisiva
decisiv	decisiva
decisive	decisiva
declarând	dichiarando
declarată	dichiarata
declarat	dichiarato
declarate	dichiarate
declarație	dichiarazione
declarații	dichiarazioni
declin	declino
declinul	declino
declinului	declino
decolare	decollo
decret	decreto
decrete	decreti
decretele	decreti
decretul	decreto
defensivă	difensiva
defensiv	difensiva
defensive	difensive
deficitul	deficit
deficitului	deficit
definește	definisce
defini	definire
definirea	definizione
definită	definita
definit	definita
definite	definiti
definitivă	definitiva
definitiv	definitiva
degradare	degrado
delicată	delicata
delicat	delicato
delicate	delicati
deltă	delta
demisioneze	dimissioni
demnitari	dignitari
democrația	democrazia
democratică	democratica
democratic	democratico
democratice	democratiche
democrație	democrazia
democrației	democrazia
democrații	democrazie
demografic	demografico
demografice	demografica
demografie	demografia
demonii	demoni
demonstra	dimostrare
demonstrând	dimostrando
demonstrat	dimostrato
demonstrează	dimostra
demonstreze	dimostrare
densă	densa
densitatea	densità
densitate	densità
departament	dipartimento
departamente	dipartimenti
departamentele	dipartimenti
departamentelor	dipartimenti
departamentul	dipartimento
dependența	dipendente
dependentă	dipendenza
dependență	dipendenza
dependente	dipendenti
dependenței	dipendenza
depinde	dipende
deportărilor	deportazioni
deportat	deportato
deportate	deportati
deportați	deportati
depresia	depressione
depresie	depressione
depresiune	depressione
deputat	deputato
derivat	derivato
descendentă	discendente
descendenții	discendenti
descendenților	discendenti
descoperite	scoperto
descoperit	scoperte
descrie	descrive
descrieri	descrizione
descris	descritto
descrise	descritte
deșert	deserti
designul	design
destinată	destinata
destinație	destinazione
destinații	destinazioni
destinele	destini
destinul	destino
detaliile	dettagli
detaliu	dettagli
detenție	detenzione
determină	determina
determina	determinare
determinarea	determinare
determinare	determinazione
determinată	determinata
deținut	detenuto
devastarea	devastazione
devastată	devastata
devastat	devastato
devastator	devastante
devastează	devastando
dezacord	disaccordo
dezacordul	disaccordo
dezastru	disastro
dezastruoasă	disastrosa
dezastruoase	disastrose
dezastruos	disastrosa
dezordine	disordine
diabet	diabete
diabetul	diabete
diabetului	diabete
diagnosticarea	diagnosi
diagnosticat	diagnosticato
diagnosticul	diagnosi
diagrame	diagrammi
dialect	dialetto
dialecte	dialetti
dialog	dialogo
dialogul	dialogo
dialogului	dialogo
dialoguri	dialoghi
dialogurile	dialoghi
diamante	diamanti
diamantele	diamanti
diaree	diarrea
diasporei	diaspora
dictat	dettato
dictator	dittatore
dictatorul	dittatore
dictatorului	dittatore
dictatura	dittatura
dictatură	dittatura
dictaturii	dittatura
dicționar	dizionario
didactice	didattici
diferență	differenza
diferențe	differenze
diferențele	differenze
diferenția	differenziare
diferențiat	differenziato
diferențiate	differenziate
diferențierea	differenziare
diferite	differenti
dificilă	difficile
dificil	difficile
dificile	difficili
dificultate	difficoltà
dificultăți	difficoltà
dilema	dilemma
dimensiunea	dimensione
dimensiune	dimensione
dimensiuni	dimensioni
dimensiunii	dimensione
dimensiunile	dimensioni
dinamica	dinamica
dinamică	dinamiche
dinamic	dinamico
dinamice	dinamiche
dinastică	dinastico
dinozaur	dinosauro
dinozaurilor	dinosauri
diplomă	diploma
diplomația	diplomazia
diplomatică	diplomatica
diplomatic	diplomatico
diplomatice	diplomatiche
diplomație	diplomazia
diplomației	diplomazia
diplomații	diplomatici
diplome	diplomi
directă	diretta
direct	diretta
directe	dirette
direcție	direzione
direcții	direzioni
direcțiile	direzioni
directiva	direttiva
directivă	direttiva
directivei	direttiva
directivele	direttive
directoarea	direttrice
director	direttore
directori	direttori
directorii	direttori
directorilor	direttori
directorul	direttore
directorului	direttore
disciplină	disciplina
disciplinare	disciplinari
disciplinei	disciplina
disciplinele	discipline
discotecă	discoteca
discretă	discreta
discriminarea	discriminazione
discriminare	discriminazione
discriminări	discriminazioni
discriminării	discriminazioni
discurs	discorso
discursul	discorso
discursului	discorso
discursuri	discorsi
discursurile	discorsi
discutabilă	discutibile
discuta	discutere
discutată	discussa
discutat	discusso
discutate	discusse
discuții	discussioni
disident	dissidente
dispare	scompare
disponibilă	disponibile
disponibil	disponibile
disponibile	disponibili
disponibilitatea	disponibilità
disponibilitate	disponibilità
dispoziție	disposizione
dispoziții	disposizioni
dispozitive	dispositivi
dispozitivele	dispositivi
dispun	dispongono
dispune	dispone
dispusă	disposta
dispus	disposto
dispuse	disposte
distanță	distanza
distilarea	distillazione
distinctă	distinta
distincte	distinte
distincție	distinzione
distinctive	distintive
disting	distinguono
distinge	distingue
distribui	distribuire
distribuie	distribuire
distribuirea	distribuzione
distribuire	distribuzione
distribuită	distribuita
distribuit	distribuita
distribuite	distribuiti
distribuitori	distributori
distribuție	distribuzione
districtul	distretto
distructive	distruttiva
distruge	distrugge
distruse	distrutte
divergente	divergenti
diversă	diversificata
diversificarea	diversificazione
diversificare	diversificazione
diversificată	diversificata
diversificate	diversificata
diversitatea	diversità
diversitate	diversità
diversității	diversità
diversiune	diversivo
divină	divino
divizat	divisa
divizate	divisa
diviziunea	divisione
diviziuni	divisioni
diviziunile	divisioni
divorț	divorzio
divorțeze	divorziare
divorțul	divorzio
divorțului	divorzio
doarmă	dormono
doarme	dorme
doctorale	dottorato
doctoranzi	dottorato
doctrina	dottrina
doctrină	dottrina
doctrinei	dottrina
doctrinelor	dottrine
documentară	documentaria
documentar	documentario
documentarea	documentare
documentată	documentata
documentat	documentata
documentate	documentati
documentația	documentazione
documente	documenti
documentele	documenti
documentelor	documenti
documentul	documento
dogmă	dogma
dogmatică	dogmatica
dogme	dogmi
dogmele	dogmi
dolar	dollaro
dolari	dollari
dolarul	dollaro
domestică	domestica
domestice	domestiche
domiciliu	domicilio
domină	domina
domina	dominare
dominantă	dominante
dominante	dominanti
dominată	dominata
dominat	dominata
dominate	dominati
dominația	dominio
domine	dominare
donator	donatore
dosar	dossier
drama	dramma
dramă	dramma
dramatică	drammatica
dramatic	drammatica
drame	drammi
drastică	drastica
drastic	drasticamente
droguri	droga
dulce	dolce
durat	durato
duratei	durata
dureze	durare
duzină	dozzina
echivalentă	equivalente
echivalente	equivalenti
echivalent	equivalente
ecleziastică	ecclesiastica
ecleziastice	ecclesiastiche
ecologică	ecologica
ecologic	ecologico
ecologice	ecologici
ecologie	ecologia
ecologiei	ecologia
economia	economia
economică	economica
economic	economico
economice	economiche
economie	economia
economiei	economia
economii	economie
economiile	economie
economist	economista
economiști	economisti
ecosistem	ecosistema
ecosisteme	ecosistemi
ecuatorială	equatoriale
editor	editore
editorială	editoriale
editoriale	editoriali
educare	educazione
educative	educativi
efecte	effetti
efect	effetto
efectivă	effettiva
efectuate	effettuate
efectuat	effettuato
efectueze	effettuare
eficace	efficace
eficacitatea	efficacia
eficientă	efficiente
eficiente	efficienti
eficient	efficiente
egiptene	egiziane
egipteni	egiziani
elaborată	elaborata
elaborate	elaborati
elaborat	elaborato
elaboreze	elaborare
electorală	elettorale
electorale	elettorale
electoral	elettorale
electorat	elettorato
electoratul	elettori
electrică	elettrica
electrice	elettriche
electric	elettrico
electricitate	elettricità
electrificată	elettrificata
electromagnetice	elettromagnetiche
electronică	elettronica
electronice	elettroniche
electronic	elettronico
electronicii	elettronica
elegante	eleganti
elementare	elementari
elementar	elementare
elemente	elementi
element	elemento
elibera	liberare
eliberează	liberando
elibereze	liberare
elicoptere	elicotteri
elicopterele	elicotteri
elicopter	elicottero
elicopterul	elicottero
eligibil	eleggibile
elimină	elimina
elimina	eliminare
eliminând	eliminando
eliminată	eliminata
eliminate	eliminati
eliminat	eliminato
elimine	eliminare
elită	elite
elite	élite
elitei	élite
elitele	elite
emanciparea	emancipazione
emblematic	emblematico
emigrat	emigrato
emigreze	emigrare
emoțional	emozionale
empirică	empirica
empirice	empiriche
empiric	empirico
endemică	endemica
endemice	endemiche
energetice	energetiche
energetic	energetico
energia	energia
energic	energica
energie	energia
energiei	energia
energiile	energie
enigmă	enigma
enormă	enorme
enorme	enormi
entitate	entità
entități	entità
entuziasm	entusiasmo
entuziasmul	entusiasmo
entuziast	entusiasta
enzimă	enzima
enzimele	enzimi
eolian	eolico
eoliene	eolica
epidemie	epidemia
epidemiei	epidemia
epidemii	epidemia
epidemiile	epidemie
episoade	episodi
episod	episodio
ereditare	ereditarie
eroare	errore
eronate	errate
escală	scalo
esențială	essenziale
esențiale	essenziali
esențial	essenziale
estetice	estetiche
estimări	stimare
estima	stime
estimată	stimata
estimate	stimate
estimat	stimato
estimează	stima
estonian	estone
est-vest	est-ovest
etnice	etniche
etnic	etnico
etnie	etnia
europeană	europea
european	europeo
europene	europee
europeni	europei
evacuate	evacuare
evacueze	evacuare
evaluate	valutato
evaluat	valutare
evalua	valutate
evaluează	valuta
evenimente	avvenimenti
eveniment	evento
eventuala	eventuale
evidente	evidenti
evident	evidente
evită	evita
evoluat	evolute
evolueze	evolvere
evoluție	evoluzione
exacte	esatte
exagerare	esagerato
exagerat	esagerato
examina	esaminare
examinat	esaminato
examinează	esamina
excelența	eccellente
excelentă	eccellenza
excelență	eccellenza
excelent	eccellenti
excelente	eccellente
excepțională	eccezionale
excepțional	eccezionali
excepționale	eccezionale
exces	eccesso
excesiv	eccessive
excesive	eccessiva
exclude	esclude
exclusă	esclusa
excluse	escluse
exclus	escluso
excluși	esclusi
exclusivă	esclusiva
exclusive	esclusive
exclusiv	esclusivamente
excluzând	escludendo
excursii	escursioni
executivă	esecutiva
executive	esecutivi
executiv	esecutivo
executivi	esecutivi
exemplară	esemplare
exemplare	esemplari
exemplar	esemplare
exemple	esempi
exercită	esercita
exercita	esercitare
exercitată	esercitata
exercitate	esercitate
exercite	esercitare
exerciții	esercizi
exercițiu	esercizio
exilat	esiliato
există	esiste
existentă	esistente
existența	esistenza
existență	esistenza
existente	esistenti
existent	esistente
existențială	esistenziale
exotică	esotica
exotice	esotiche
expansiunea	espansione
expansiune	espansione
experiența	esperienza
experiență	esperienza
experiențe	esperienze
experimentală	sperimentali
experimentale	sperimentale
experimental	sperimentare
experimenta	sperimentale
experimente	esperimenti
experimentele	esperimenti
experimentelor	esperimenti
experimenteze	sperimentare
experți	esperti
experții	esperti
explicită	esplicita
explicit	esplicito
explodat	esplosa
explodează	esplode
explora	esplorare
explorarea	esplorazione
explorată	esplorata
explorat	esplorato
exploreze	esplorare
explozie	esplosione
explozii	esplosioni
explozivă	esplosiva
explozive	esplosive
exponențială	esponenziale
exponențial	esponenziale
exportate	esportati
exportat	esportato
expresie	espressione
expresii	espressioni
expresiile	espressioni
exprimă	esprime
exprima	esprimere
exprime	esprimersi
expulzați	espulsi
expune	espone
exterior	estero
exterminare	sterminio
externe	esterne
extern	esterno
externi	esterni
extracție	estrazione
extrage	estrarre
extraordinară	straordinaria
extraordinare	straordinarie
extraordinar	straordinaria
extrase	estratte
extrema	estrema
extremă	estrema
extreme	estreme
extremiste	estremisti
fabricarea	fabbricazione
fabricat	fabbricato
facilita	facilitare
facilitând	facilitando
facilitarea	facilitare
facilitat	facilitato
faciliteze	facilitare
factor	fattore
factori	fattori
factorii	fattori
factorul	fattore
factură	fattura
faimoase	famosi
faimoasei	famosa
faliment	fallimento
false	falsi
falsificarea	falsificazione
familia	famiglia
familială	familiare
familiale	familiare
familie	familiare
familiei	familiari
familii	famiglia
familiile	famiglie
familiilor	familiari
fanatic	fanatico
fantastică	fantastico
fantastic	fantastico
fantezia	fantasie
fantezie	fantasia
fantomă	fantasma
fantome	fantasmi
fapte	fatti
farmaceutică	farmaceutica
farmaceutice	farmaceutiche
farmaceutic	farmaceutica
farmacie	farmacia
farmacist	farmacista
farsă	farsa
fascinat	affascinato
fascism	fascismo
fascismul	fascismo
fascismului	fascismo
fasciste	fascisti
fascist	fascista
fatală	fatale
fatale	fatali
faună	fauna
faunei	fauna
favorabile	favorevoli
favorabil	favorevole
favorizate	favorita
favorizat	favorito
favorizează	favorisce
federală	federale
federale	federali
federal	federale
feline	felini
feminismul	femministe
feministă	femminista
feminist	femminista
ferestre	finestre
fermă	ferma
fermitate	fermamente
feroviară	ferroviaria
feroviare	ferroviarie
fertile	fertili
fertil	fertile
fertilitatea	fertilità
fertilitate	fertilità
festivaluri	festival
fiabilitatea	affidabilità
fibră	fibra
fibrele	fibre
fibrelor	fibre
fidelă	fedele
fidel	fedele
fideli	fedeli
filiala	filiale
filiale	filiali
filialele	filiali
filmat	filmato
filosofice	filosofica
filosofie	filosofia
filozofie	filosofia
filtrare	filtro
filtre	filtri
filtru	filtro
finală	finale
finale	finali
financiară	finanziaria
financiare	finanziarie
financiar	finanziario
finanța	finanziare
finanțarea	finanziare
finanțare	finanziamenti
finanțată	finanziata
finanțate	finanziati
finanțat	finanziato
finanțele	finanze
finanțelor	finanze
finanțeze	finanziare
finite	finiti
finlandeze	finlandese
finlandezi	finlandesi
fiscală	fiscale
fiscale	fiscali
fiscal	fiscale
fisiune	fissione
flexibilă	flessibile
flexibile	flessibile
flexibil	flessibile
flexibilitate	flessibilità
floră	flora
florei	flora
flota	flotta
flotă	flotta
flote	flotte
flotei	flotta
flotele	flotte
flotila	flottiglia
flotilei	flottiglia
fluctuații	fluttuazioni
fluide	fluidi
fluid	fluido
fluviale	fluviali
fluvial	fluviale
folclor	folclore
fondatoare	fondatore
fondator	fondatore
fondatorii	fondatori
fondatorul	fondatore
fonduri	fondi
forestieră	forestale
forestiere	forestale
forestier	forestale
formă	forma
formală	formale
formale	formali
formal	formale
formarea	formazione
formare	formazione
formate	formati
formatele	formati
format	formato
formatul	formato
formează	formano
forme	forma
formele	forme
formelor	forme
formeze	formare
formulă	formula
formularea	formulazione
formulare	formulazione
formulări	formulazioni
formulată	formulata
formulat	formulata
formulează	formula
formule	formula
forță	forza
fortăreața	fortezza
fortăreață	fortezza
forțele	forze
forumul	forum
forumuri	forum
fosilă	fossile
fosili	fossili
fotografiat	fotografare
fotografie	fotografia
fotografii	fotografia
fragilă	fragile
fragile	fragili
fragil	fragile
fragmentarea	frammentazione
fragmentare	frammentazione
fragmentată	frammentato
fragmentat	frammentato
frânare	frenatura
franceză	francese
franceze	francese
francezi	francesi
frecvente	frequenti
frontieră	frontiera
frontierei	frontiera
frontierele	frontiere
frontierelor	frontiere
fronturi	fronti
fronturile	fronti
fructe	frutta
fumat	fumare
funcționa	funzionare
funcțională	funzionale
funcționale	funzionale
funcțional	funzionale
funcționalitatea	funzionalità
funcționar	funzionario
funcționari	funzionari
funcționat	funzionato
funcționează	funziona
funcționeze	funzionare
fundamentală	fondamentale
fundamentale	fondamentali
fundamental	fondamentale
fundamentele	fondamenta
fundamentul	fondamento
fundație	fondazione
funeraliile	funerale
furnizarea	fornitura
furnizată	fornita
furnizate	fornite
furnizat	fornito
furnizor	fornitore
fuziune	fusione
galeria	galleria
gamă	gamma
garaj	garage
garanta	garantire
garantarea	garanzia
garantată	garantita
garantate	garantiti
garantat	garantito
garantează	garantisce
garanție	garanzia
garanții	garanzie
gardă	guardia
gardian	guardiano
gardianul	guardiana
gardienii	guardiani
genera	generare
generală	generale
generale	generali
general	generale
genetice	genetiche
genitale	genitali
genocid	genocidio
genocidul	genocidio
genocidului	genocidio
geografice	geografiche
geologică	geologica
geologice	geologiche
geometrice	geometriche
geometrie	geometria
geopolitică	geopolitica
geopolitice	geopolitica
georgiană	georgiana
georgian	georgiano
georgiene	georgiana
georgieni	georgiani
gestionarea	gestione
gestionare	gestione
gesturi	gesti
ghetou	ghetto
ghetouri	ghetti
gigant	gigante
glaciară	glaciale
globală	globale
glorie	gloria
glorioasă	gloriosa
grădină	giardino
graduală	graduale
grafice	grafica
grame	grammi
gratuită	gratuita
gratuite	gratuiti
gratuit	gratuito
gravă	grave
grave	gravi
gravitatea	gravità
grecești	greche
grotesc	grottesco
grupul	gruppo
grupurile	gruppi
guverna	governare
guvernamentală	governativa
guvernamentale	governative
guvernamentali	governativi
guvernare	governance
guvernată	governata
guvernat	governato
guvernator	governatore
guvernatori	governatori
guvernatorii	governatori
guvernatorul	governatore
guvernează	governano
guverne	governi
guvernele	governi
guvern	governo
guvernul	governo
habitate	habitat
habitatelor	habitat
habitatul	habitat
habitatului	habitat
haotică	caotica
haotic	caotico
harta	cartina
hectar	ettaro
hegemonia	egemonia
hemoragii	emorragia
hibride	ibridi
hibrid	ibrida
hidraulică	idraulica
hidrocarburi	idrocarburi
hidroelectrică	idroelettrica
hidroelectrice	idroelettriche
hidrogen	idrogeno
hidrografic	idrografico
hochei	hockey
holeră	colera
holocaustul	olocausto
holocaustului	olocausto
homosexuale	omosessuali
homosexualilor	omosessualità
homosexualitate	omosessualità
homosexualității	omosessuale
homosexual	omosessuali
hormonii	ormoni
hormoni	ormonale
icoane	icone
ideală	ideale
ideale	ideali
ideal	ideale
idealist	idealista
identică	identica
identice	identiche
identic	identica
identifică	identifica
identifica	identificare
identificare	identificazione
identificată	identificata
identificate	identificati
identificat	identificato
identifice	identificare
identitatea	identità
identitate	identità
identități	identità
identității	identità
ideologia	ideologia
ideologică	ideologica
ideologice	ideologiche
ideologic	ideologica
ideologie	ideologia
ideologiei	ideologia
ideologii	ideologia
ierarhia	gerarchia
ierarhice	gerarchico
ierarhie	gerarchia
ierarhiei	gerarchia
ignoră	ignora
ignora	ignorare
ignorând	ignorando
ignorată	ignorata
ignorate	ignorati
ignorat	ignorato
ignore	ignorare
ilegală	illegale
ilegale	illegale
ilegal	illegale
ilegitim	illegittima
ilustra	illustrare
ilustrată	illustrata
ilustrează	illustra
iluștri	illustri
iluzie	illusione
imagina	immaginare
imaginară	immaginaria
imaginare	immaginari
imaginație	immaginazione
imaginat	immaginato
imaginea	immagine
imagine	immagine
imagini	immagini
imaginile	immagini
imediată	immediata
imediate	immediate
imediat	immediato
imigranții	immigranti
imigranți	immigrati
imigranților	migranti
imigrația	immigrazione
imigrației	immigrazione
imigrație	immigrazione
iminentă	imminente
iminent	imminente
imitat	imitare
imobiliară	immobiliare
imobiliare	immobiliare
imobiliar	immobiliare
impact	impatto
impactul	impatto
imperativ	imperativo
imperfect	imperfetto
imperială	imperiale
implică	implica
implicații	implicazioni
implicațiile	implicazioni
implicită	implicita
implicit	implicitamente
importanța	importante
importantă	importanza
importanță	importanza
importante	importanti
importate	importati
importat	importato
import	importazione
importuri	importazioni
importurile	importazioni
importurilor	importazioni
imposibilă	impossibile
imposibile	impossibili
imposibil	impossibile
impozit	imposta
impresia	impressione
impresie	impressione
impresiile	impressioni
impresionantă	impressionante
impresionante	impressionanti
impresionant	imponente
improvizat	improvvisata
impuls	impulso
impulsul	impulso
impulsuri	impulsi
impune	impone
impunerea	imporre
impusă	imposta
impuse	imposte
imunitar	immunitario
imunitatea	immunità
imunitate	immunità
imunității	immunità
inaugurală	inaugurale
inaugurarea	inaugurazione
inaugurată	inaugurata
inaugurat	inaugurato
încadrat	inquadrato
incapabilă	incapace
incapabil	incapace
incapacitatea	incapacità
incapacitate	incapacità
incendii	incendi
incendiile	incendi
incendiilor	incendi
incendiu	incendio
incertă	incerta
incert	incerto
incertitudinea	incertezza
incertitudine	incertezza
incidente	incidenti
incidentul	incidente
incidentului	incidente
includă	includere
includea	includeva
include	includere
includ	includono
inclusă	inclusa
incluse	inclusi
incolor	incolore
incompatibile	incompatibili
incompletă	incompleta
incomplete	incompleta
incomplet	incompleta
încorpora	incorporare
încorporate	incorporate
incredibile	incredibili
încurajarea	incoraggiare
incursiuni	incursioni
independența	indipendente
independentă	indipendenza
independență	indipendenza
independenței	indipendenza
independente	indipendente
independent	indipendente
indiană	indiana
indian	indiani
indică	indica
indicând	indicando
indicativ	indicativo
indicatorii	indicatori
indicator	indicatore
indice	indicare
indicele	indice
indicelui	indice
indicii	indizi
indiciu	indice
indiene	indiane
indieni	indiani
indiferență	indifferenza
indigenă	indigena
indigene	indigeni
indirectă	indiretta
indirecte	indirette
indispensabilă	indispensabile
indispensabile	indispensabili
indispensabil	indispensabile
individ	individuo
individuală	individuale
individuale	individuali
individual	individuale
individului	individuo
indivizi	individui
indivizilor	individui
indonezian	indonesiano
industria	industria
industrială	industriale
industriale	industriali
industrial	industriale
industrializare	industrializzazione
industrializării	industrializzazione
industriei	industria
industrie	industria
industrii	industrie
industriile	industrie
industriilor	industrie
ineficientă	inefficace
ineficiente	inefficaci
ineficient	inefficace
inerente	inerenti
inevitabilă	inevitabile
inevitabil	inevitabile
inexistentă	inesistente
inexistente	inesistente
inexistent	inesistente
infantilă	infantile
infectate	infette
infectat	infettato
infecție	infezione
infecțioase	infettive
infiltrarea	infiltrazioni
infinit	infinito
inflația	inflazione
inflației	inflazione
influența	influente
influentă	influenza
influență	influenza
influențate	influenzati
influențat	influenzato
influente	influenti
influențele	influenze
influențeze	influenzare
influenți	influenti
informa	informare
informală	informale
informale	informali
informal	informale
informarea	informare
informare	informazione
informatică	informatica
informatice	informatiche
informatic	informatico
informației	informazione
informații	informazioni
informațiile	informazioni
informați	informati
informat	informato
informator	informatore
informează	informa
informeze	informare
infrastructura	infrastrutture
infrastructură	infrastrutture
infrastructurii	infrastrutture
ingineria	ingegneria
inginerie	ingegneria
inginer	ingegnere
ingrediente	ingredienti
ingredientele	ingredienti
ingredient	ingrediente
inițială	iniziale
inițiale	iniziali
inițial	iniziale
inițiativa	iniziativa
inițiativă	iniziativa
inițiativei	iniziativa
inițiative	iniziative
inițiativele	iniziative
inovații	innovazioni
inovatoare	innovativa
inovator	innovativo
înregistrarea	registrazione
înregistrare	registrazione
înregistrării	registrazioni
înregistrările	registrazioni
înregistrări	registrazione
înregistrată	registrata
înregistrate	registrate
înscrise	inserite
insecte	insetti
insistă	insiste
insistența	insistenza
inspecție	ispezione
inspector	ispettore
inspectorul	ispettore
inspiră	ispira
inspira	ispirare
inspirată	ispirata
inspirate	ispirate
inspirația	ispirazione
inspirație	ispirazione
inspirat	ispirato
inspire	ispirare
instabilă	instabile
instabile	instabili
instabil	instabile
instabilitatea	instabilità
instabilitate	instabilità
instala	installare
instalare	installare
instalată	installata
instanță	istanza
instantanee	istantanea
instantaneu	istante
institutele	istituti
instituției	istituzione
instituție	istituzione
instituții	istituzioni
instituțiile	istituzioni
instituțiilor	istituzioni
instituțională	istituzionale
instituționale	istituzionali
instituțional	istituzionale
institutul	istituto
instrucțiuni	istruzioni
instrucțiunile	istruzioni
instructori	istruttori
instrumentală	strumentale
instrumentele	strumenti
instrumentelor	strumenti
instrumente	strumenti
insuficientă	insufficiente
insuficiente	insufficiente
insuficient	insufficiente
insulară	insulare
intactă	intatta
intacte	intatte
intact	intatto
integra	integrare
integrantă	integrante
integrare	integrazione
integrată	integrata
integrate	integrata
integrează	integra
integreze	integrare
integritatea	integrità
integritate	integrità
intelectuală	intellettuale
intelectuale	intellettuale
intelectualii	intellettuali
inteligența	intelligente
inteligentă	intelligenza
inteligente	intelligente
inteligent	intelligente
intensă	intensa
intense	intensi
intensitatea	intensità
intensivă	intensiva
intensive	intensiva
intensiv	intensiva
intenția	intenzione
intenții	intenzioni
intențiile	intenzioni
intenționat	intenzionalmente
intenționează	intendono
interacționa	interagire
interacțiunea	interazione
interacțiune	interazione
interacțiunile	interazioni
interactivă	interattiva
interactive	interattiva
interactiv	interattiva
interceptat	intercettato
intercontinentală	intercontinentale
interdicție	interdizione
interdisciplinară	interdisciplinare
interdisciplinar	interdisciplinare
interesantă	interessante
interesante	interessanti
interesant	interessante
interesată	interessata
interesate	interessate
interesat	interessato
interesează	interessa
interese	interesse
interfață	interfaccia
interfețe	interfaccia
interimară	interim
intermediară	intermedia
intermediare	intermedia
internă	interna
internațională	internazionale
internaționale	internazionale
internațional	internazionale
interne	interna
intern	interno
interogare	interrogatori
interogat	interrogato
interpreta	interpretare
interpretarea	interpretazione
interpretare	interpretazione
interpretării	interpretazione
interpretări	interpretazioni
interpretările	interpretazioni
interpretată	interpretata
interpretate	interpretati
interpretat	interpretato
interpretează	interpreta
interpreteze	interpretando
interpreții	interpreti
interpreților	interpreti
interpret	interprete
interpretul	interprete
intervale	intervalli
interveni	intervenire
intervenit	intervenuta
intervenția	intervento
intervenției	intervento
intervenție	intervento
intervină	intervenire
intervine	interviene
intervin	intervengono
interviu	intervista
interviul	intervista
interviurile	interviste
intime	intima
intitulată	intitolata
intitulate	intitolate
intitulat	intitolata
intra	entrare
intre	entrare
întreprins	intrapreso
intrinsecă	intrinseca
intrinsec	intrinseco
introducă	introdurre
introducând	introducendo
introduce	introdurre
introducerea	introdurre
introducere	introduzione
introduc	introducono
introductiv	introduttiva
introdusă	introdotta
introduse	introdotte
introdus	introdotto
întrunit	riunito
inundații	inondazioni
inundațiilor	inondazioni
inutilă	inutile
inutile	inutili
inutil	inutile
invazie	invasione
invazii	invasione
invaziilor	invasioni
inventar	inventario
inventată	inventata
inventat	inventato
inventatori	inventori
inventator	inventore
inventatorul	inventore
invenții	invenzioni
invențiile	invenzioni
inversă	inversa
inversa	invertire
inversate	invertiti
inversat	invertita
invers	viceversa
investiție	investimento
investițiile	investimenti
investit	investito
investitorii	investitori
investitorilor	investitori
invită	invita
invitată	invitata
invitate	invitati
invitați	invitati
invitat	invitato
invizibilă	invisibile
invizibile	invisibile
invocând	invocando
involuntar	involontariamente
irakiene	irachene
irakieni	iracheni
iraniană	iraniana
iranian	iraniano
iraniene	iraniana
iranieni	iraniani
ireversibile	irreversibile
ireversibil	irreversibile
irigație	irrigazione
iritat	irritato
irlandeză	irlandese
irlandeze	irlandese
irlandezi	irlandesi
irlandez	irlandese
ironia	ironia
ironic	ironico
islamică	islamica
islamice	islamiche
islamic	islamico
islamul	islam
islandeze	islandese
islandez	islandese
israeliană	israeliana
israelian	israeliano
israeliene	israeliane
israelieni	israeliani
istoria	storia
istorică	storica
istorice	storiche
istoric	storica
istoriei	storia
istorie	storia
istorii	storie
italiana	italiana
italiană	italiano
italian	italiano
italiene	italiane
italieni	italiani
iugoslav	jugoslavi
izotopii	isotopi
jandarmerie	gendarmeria
jandarmeriei	gendarmeria
japonezi	giapponesi
judiciară	giudiziaria
judiciare	giudiziarie
judiciar	giudiziario
jungla	giungla
junglă	giungla
juridică	giuridica
juridice	giuridiche
juridic	giuridica
jurisprudența	giurisprudenza
juriști	giuristi
jurnalism	giornalismo
jurnalismul	giornalismo
jurnalistă	giornalista
jurnalist	giornalisti
jurnalistice	giornalista
jurnalistic	giornalistiche
jurnaliști	giornalisti
jurnaliștii	giornalistica
jurnalistul	giornalista
justifică	giustifica
justifica	giustificare
justificarea	giustificare
justificare	giustificazione
justificată	giustificata
justificat	giustificata
justifice	giustificare
kilograme	chilogrammi
kilometri	chilometri
kilometru	chilometro
kurde	curdi
labirint	labirinto
laboratoare	laboratori
laboratoarele	laboratori
laborator	laboratorio
lacrimi	lacrime
laice	laiche
lansate	lanciati
lapte	latte
lasă	lascia
latentă	latente
latina	latino
latine	latino
lectură	lettura
legală	legale
legale	legali
legalitatea	legalità
legalitate	legalità
legal	legale
legenda	leggenda
legendar	leggendaria
legislația	legislazione
legislației	legislazione
legislație	legislazione
legislativă	legislativa
legislative	legislativa
legislativ	legislativo
legislatură	legislatura
legislaturi	legislatura
legitimă	legittima
legitime	legittimi
legitimitatea	legittimità
legitimitate	legittimità
legitim	legittimo
lentă	lenta
lente	lenti
lesbiene	lesbiche
letonă	lettone
letoni	lettoni
leton	lettone
liberală	liberale
liberale	liberali
liberă	libera
liberalism	liberalismo
liberalismul	liberalismo
liberalismului	liberalismo
liberalizarea	liberalizzazione
liberalizare	liberalizzazione
liberal	liberale
libere	libera
libertatea	libertà
libertate	libertà
libertății	libertà
libian	libico
licență	licenza
licențe	licenze
lideri	leader
lider	leader
limita	limitare
limită	limite
limitarea	limitare
limitare	limitazione
limitări	limitazioni
limitată	limitata
limitate	limitata
limitat	limitata
limitează	limita
limitele	limiti
limite	limiti
limitelor	limiti
limiteze	limitare
linear	lineare
lingvistică	linguistica
lingvistice	linguistiche
lingvistic	linguistico
liniară	lineare
liniar	lineare
linie	linea
liniile	linee
listă	lista
listele	liste
listelor	liste
literal	letteralmente
literalmente	letteralmente
literară	letteraria
literare	letterarie
literar	letteraria
literatura	letteratura
literatură	letteratura
litru	litro
lituaniană	lituana
lituanian	lituano
lituaniene	lituana
lituanieni	lituani
locală	locale
locale	locali
localizarea	localizzare
localizată	localizzato
local	locale
locomotivă	locomotiva
locomotivele	locomotive
logică	logica
logice	logiche
logic	logica
logistică	logistica
logistice	logistiche
logistic	logistica
londoneze	londinesi
londonez	londinese
longevitatea	longevità
luciditate	lucidità
lucid	lucida
luminoasă	luminosa
lungi	lunghi
lupta	lotta
luptat	lottato
macedoneană	macedone
macedonean	macedone
mafiei	mafie
mafiot	mafiosi
magice	magiche
magic	magica
majoritară	maggioritaria
majoritare	maggioritaria
malarie	malaria
maltez	maltese
mamifere	mammiferi
mamifer	mammifero
mandatele	mandati
mandatelor	mandati
mandate	mandati
mandatul	mandato
mandatului	mandato
manevră	manovra
manevrele	manovre
manevre	manovre
manifestă	manifesta
manifestare	manifestazione
manifestat	manifestato
manipula	manipolare
manipularea	manipolazione
manipulat	manipolato
manuală	manuale
manuale	manuali
manual	manuale
manuscris	manoscritto
maraton	maratona
marca	marchio
marcarea	marcatura
marginale	marginali
marină	marina
marine	marina
maritimă	marittima
maritime	marittime
maritim	marittimi
marketingului	marketing
marmura	marmo
marocan	marocchino
martir	martire
marxismul	marxismo
marxismului	marxismo
marxistă	marxista
marxist	marxista
masacrați	massacrati
masacrele	massacri
masacre	massacri
masacrul	massacro
masacrului	massacro
masacru	massacro
masă	massa
masculin	maschi
masele	masse
masive	massicce
masiv	massicci
măsura	misura
măsură	misura
măsurarea	misurare
măsurare	misurare
măsurate	misurate
măsurat	misurato
măsurile	misure
măsuri	misure
matematică	matematica
matematice	matematici
matematic	matematico
materială	materiale
materialele	materiale
materialelor	materiale
materiale	materiali
material	materiale
materie	materia
maternă	materna
materne	materna
maternitate	maternità
matern	materno
matrimonială	matrimoniale
matură	matura
mature	matura
maturitatea	maturità
maturitate	maturità
matur	maturo
maximă	massima
maxime	massime
maxim	massimo
mecanice	meccaniche
mecanic	meccanicamente
mecanismele	meccanismi
mecanismelor	meccanismi
mecanisme	meccanismi
mecanism	meccanismo
mecanismul	meccanismo
mecanismului	meccanismo
medaliei	medaglia
mediatică	mediatica
mediatic	mediatico
mediator	mediatore
medicale	mediche
medical	medico
medicamentele	medicinali
medicament	medicina
medicină	medicina
medievale	medioevali
medieval	medievale
mediocru	mediocre
mediteraneană	mediterranea
mediteranean	mediterraneo
mediteraneene	mediterranea
melancolie	malinconia
membră	membro
membre	membri
membru	membro
memorandumul	memorandum
memoriei	memoria
memorie	memoria
mentală	mentale
mentalitatea	mentalità
mentalitate	mentalità
mental	mentalmente
menționată	menzionata
menționat	menzionato
mercenarilor	mercenari
mercenar	mercenarie
mercur	mercurio
meritele	meriti
meritelor	meriti
merite	meriti
mesagerul	messaggero
metabolice	metaboliche
metalice	metallica
metal	metallo
metalurgic	metallurgia
metan	metano
meteorologică	meteorologica
meteorologice	meteorologiche
meteorologic	meteorologico
metoda	metodo
metodă	metodo
metodei	metodo
metodele	metodi
metode	metodi
metodologice	metodologico
metodologic	metodologico
metodologie	metodologia
metodologii	metodologia
metrice	metriche
metroul	metropolitana
metru	metro
mexicană	messicana
mexicane	messicane
mexican	messicano
microfon	microfono
microorganisme	microrganismi
microunde	microonde
migrația	migrazione
migrației	migrazione
migrație	migratori
migratoare	migratori
miliarde	miliardi
miliard	miliardo
milioane	milioni
milion	milione
militantă	militante
militară	militare
militare	militari
militar	militare
miliției	milizia
milițiile	milizie
minele	miniere
minelor	miniere
minerală	minerale
minerale	minerali
mineral	minerale
minereu	minerale
minereuri	minerali
miniatură	miniatura
minieră	mineraria
miniere	minerarie
minimă	minima
minime	minima
minim	minimo
ministerele	ministeri
ministerelor	ministeri
ministere	ministeri
ministerială	ministeriale
ministeriale	ministeriali
ministerial	ministeriale
miniștrii	ministri
miniștrilor	ministri
ministrul	ministro
ministru	ministro
minoră	minorenne
minore	minori
minori	minorenni
minoritară	minoritaria
minoritatea	minoranza
minoritate	minoranza
minor	minorenne
mintală	mentale
mintale	mentale
minuscule	minuscole
minute	minuti
minut	minuto
miracole	miracoli
miracol	miracolo
miraculoasă	miracolosa
miraculos	miracolosa
misionari	missionari
misionar	missionario
misiunea	missione
misiune	missione
misiunii	missione
misiuni	missioni
misterioase	misteriose
mister	mistero
mixtă	mista
mixte	miste
mizerie	miseria
moartă	morta
mobilă	mobile
mobile	mobili
mobilitatea	mobilità
mobilitate	mobilità
mobilității	mobilità
mobilizarea	mobilitazione
mobilizare	mobilitazione
mobilizării	mobilitazione
mobil	mobile
modelele	modelli
modelelor	modelli
modele	modelli
model	modello
modelul	modello
moderate	moderata
moderat	moderato
moderator	moderatore
modernă	moderna
moderne	moderna
modernitatea	modernità
modernitate	modernità
modernizarea	modernizzare
modernizare	modernizzazione
modernizării	modernizzazione
modern	moderno
modestă	modesta
modeste	modesti
modest	modesto
modifica	modificare
modificarea	modificare
modificare	modifica
modificările	modifiche
modificări	modifiche
modificată	modificata
modificate	modificati
modificat	modificata
modifice	modificare
modulele	moduli
module	moduli
moleculei	molecola
molecule	molecola
momentele	momenti
momente	momenti
momentul	momento
monarhiei	monarchia
monarhie	monarchia
monarh	monarca
mondială	mondiale
mondial	mondiale
moneda	moneta
monedă	moneta
monede	monete
monetară	monetaria
monetare	monetari
monetar	monetario
monolog	monologo
monopol	monopolio
monopolul	monopolio
monoxid	monossido
monstru	mostro
montane	montagna
montate	montanti
monumentele	monumenti
monumentelor	monumenti
monumente	monumenti
morale	morali
moralitatea	moralità
moralitate	moralità
moral	morale
mortale	mortali
mortalitatea	mortalità
mortalitate	mortalità
mortalității	mortalità
mortal	mortale
mortiere	mortai
morți	morti
motivată	motivata
motivat	motivato
motorii	motorie
motor	motore
motorul	motore
multimedia	multimediale
multinațională	multinazionale
multinaționale	multinazionali
multiplă	multipla
multiple	multipla
multiplicare	moltiplicatore
multitudine	moltitudine
municipale	municipali
munte	montane
muntoase	montuose
murit	morti
musculară	muscolare
musulmană	musulmana
musulmane	musulmana
musulmanii	musulmani
musulmanilor	musulmani
muzeu	museo
muzicală	musicale
muzicale	musicale
muzician	musicista
muzicienii	musicisti
muzicieni	musicisti
napoleoniene	napoleoniche
natalității	natalità
natal	natale
națională	nazionale
naționale	nazionali
naționalism	nazionalismo
naționalismul	nazionalismo
naționalismului	nazionalismo
naționalistă	nazionalista
naționaliste	nazionaliste
naționalist	nazionalista
naționalitate	nazionalità
național	nazionale
națiune	nazione
națiuni	nazioni
naturală	naturale
naturale	naturali
natural	naturale
natură	natura
naturii	natura
navală	navale
navale	navali
navigheze	navigare
nazism	nazismo
nazismul	nazismo
nazismului	nazismo
nazistă	nazista
naziste	nazista
naziști	nazisti
nebuloase	nebulosa
necesară	necessaria
necesare	necessarie
necesar	necessario
necesitatea	necessità
neconvenționale	convenzionali
nefavorabile	sfavorevole
negative	negativi
negativ	negative
negociat	negoziato
negocierea	negoziare
negocieze	negoziare
neguvernamentale	governative
nelegitim	illegittimo
nelimitat	illimitato
nepopular	impopolare
nervos	nervoso
netă	netta
neurologice	neurologici
neutralitatea	neutralità
neutră	neutrale
neutre	neutri
neutru	neutrale
nichel	nickel
nigerian	nigeriano
nivel	livello
nivelul	livello
niveluri	livelli
noastră	nostra
noastre	nostre
nobila	nobile
nobilă	nobile
nobile	nobili
nobil	nobile
noiembrie	novembre
nomad	nomade
nomazi	nomadi
nord-americane	nordamericani
nord-american	nordamericani
nord-estul	nord-est
nordice	nordici
nord-vest	nord-ovest
nord-vestul	nord-ovest
normală	normale
normale	normali
normandă	normanni
norvegian	norvegese
nostru	nostro
nucleară	nucleare
nucleare	nucleari
nuclear	nucleare
numere	numeri
numerotarea	numerazione
nutritive	nutrienti
obiectivele	obiettivi
obiective	obiettivi
obiectivul	obiettivo
obligând	obbligando
obligă	obbliga
obliga	obbligare
obligate	obbligati
obligație	obbligo
obligațiile	obblighi
obligațiilor	obblighi
obligați	obbligati
obligațiuni	obbligazioni
obligat	obbligato
obligatorie	obbligatoria
obligatorii	obbligatori
obligatoriu	obbligatoria
oblige	obbligare
obscură	oscura
obscure	oscuri
obscur	oscuro
observă	osserva
observare	osservazione
observațiile	osservazioni
observatorii	osservatori
observatori	osservatore
observator	osservato
observat	osservatori
obstacolele	ostacoli
obstacole	ostacoli
obstacol	ostacolo
ocazionale	occasionale
occidentală	occidentale
occidentale	occidentali
oceane	oceani
oceanice	oceaniche
ocean	oceano
octombrie	ottobre
ocupanții	occupanti
ocupă	occupa
ocupate	occupate
ocupat	occupata
ocupe	occupare
ofensiva	offensiva
ofensivă	offensiva
ofensivei	offensiva
ofensive	offensive
oferă	offre
oferea	offriva
oferită	offerta
oferite	offerte
oferte	offerte
oficială	ufficiale
oficiale	ufficiali
oficial	ufficiale
omagiu	omaggio
omogenă	omogenea
omogene	omogenee
omogen	omogeneo
onora	onorare
onorat	onorato
operațională	operativa
operațional	operativo
operațiune	operazione
operatorii	operatori
operator	operatore
opiniei	opinione
opinie	opinione
opiniile	opinioni
opinii	opinioni
oportunitate	opportunità
oportunități	opportunità
optat	optato
optime	ottimale
optimism	ottimismo
optimistă	ottimista
optimist	ottimista
optimizarea	ottimizzare
optim	ottimale
opțiune	opzione
opuse	opposte
oracolul	oracolo
orală	orale
orale	orali
orare	orarie
orchestră	orchestra
orchestrei	orchestra
ordinară	ordinaria
ordonată	ordinato
ordonate	ordinata
ordonat	ordinata
organele	organi
organelor	organi
organe	organi
organică	organica
organice	organici
organic	organico
organismele	organismi
organismelor	organismi
organisme	organismi
organism	organismo
organismul	organismo
organismului	organismo
organiza	organizzare
organizare	organizzazione
organizată	organizzata
organizate	organizzate
organizație	organizzazione
organizațiile	organizzazioni
organizațiilor	organizzazioni
organizații	organizzazioni
organizațională	organizzativa
organizat	organizzato
organizatorii	organizzatori
organizatorilor	organizzatori
organizatori	organizzatori
organizator	organizzatore
organizează	organizza
organizeze	organizzare
organ	organo
organul	organo
orientarea	orientamento
orientare	orientamento
orientări	orientamenti
orientată	orientata
orientat	orientato
originală	originale
originale	originali
originalitate	originalità
originalul	originale
originare	originari
originea	origine
origine	origine
originii	origine
originile	origini
orizontală	orizzontale
orizontale	orizzontale
orizontal	orizzontale
orizont	orizzonte
orizonturi	orizzonti
ornamentale	ornamentali
ortodocși	ortodossi
ortodoxe	ortodosse
ortodox	ortodosso
ostilă	ostile
ostile	ostili
ostil	ostilità
otomane	ottomana
pachet	pacchetto
pacient	paziente
pacientul	paziente
pacientului	paziente
palestiniană	palestinese
palestinian	palestinese
palestiniene	palestinese
palestinieni	palestinesi
palmier	palma
panica	panico
panică	panico
panou	pannello
pantalonii	pantaloni
papei	papale
parabolă	parabola
parada	parata
paradigmă	paradigma
paradoxal	paradossale
paradox	paradosso
paradoxul	paradosso
paralelă	parallela
paralele	parallele
paralel	parallelo
paralizia	paralisi
paralizie	paralisi
parametrii	parametri
parametru	parametro
paramilitară	paramilitare
paramilitare	paramilitari
parcuri	parchi
parcursă	percorsa
parfumuri	profumi
parlamentară	parlamentare
parlamentare	parlamentari
parlamentar	parlamentare
parlamentele	parlamenti
parlamentelor	parlamenti
parlament	parlamento
parlamentul	parlamento
parlamentului	parlamento
partenere	partner
partenerii	partner
partenerilor	partner
parteneri	partner
partener	partner
parțiale	parziali
participante	partecipanti
participanții	partecipanti
participanți	partecipanti
participă	partecipa
participa	partecipare
participarea	partecipazione
participare	partecipazione
participării	partecipazione
participat	partecipato
participau	partecipavano
participe	partecipare
particulele	particelle
particule	particelle
partidele	partiti
partide	partiti
partid	partito
partidul	partito
pasagerii	passeggeri
pasagerilor	passeggeri
pasageri	passeggeri
pasager	passeggero
pasiunea	passione
pasiune	passione
pasivă	passiva
pasive	passiva
pasiv	passivo
paste	pasta
patogene	patogeni
patogen	patogeno
patriarhală	patriarcale
patriarhale	patriarcale
patriarhii	patriarchi
patriarh	patriarca
patriarhului	patriarca
patrimoniul	patrimonio
patrimoniului	patrimonio
patriotică	patriottico
patriotice	patriottici
patriotism	patriottismo
patriotismul	patriottismo
patriot	patriota
patrulare	pattugliamento
pauza	pausa
pauză	pausa
pauze	pause
pavilionul	padiglione
pedagog	pedagogista
pelerinaj	pellegrinaggio
pelerinajul	pellegrinaggio
penală	penale
penale	penali
penal	penale
peninsula	penisola
peninsulei	penisola
penitenciar	penitenziario
pensie	pensione
pensiilor	pensioni
pensii	pensioni
percepția	percezione
percepție	percezione
perceput	percepito
performanța	performance
performanței	performance
pericol	pericolo
perimetrul	perimetro
perioada	periodo
perioadă	periodo
perioadele	periodi
perioade	periodi
periodică	periodica
periodice	periodiche
permanentă	permanente
permanente	permanenti
permitea	permetteva
permite	permettere
permit	permettono
persană	persiana
persane	persiana
persecutarea	persecuzione
persecutați	perseguitati
persecutat	perseguitato
persecuția	persecuzione
persecuție	persecuzione
persistă	persiste
persistentă	persistente
persistente	persistenti
persoana	persona
persoană	persona
persoanele	persone
persoanelor	persone
personajele	personaggi
personaje	personaggi
personală	personale
personale	personali
personalitatea	personalità
personalitate	personalità
personalizate	personalizzate
personal	personale
personalul	personale
personalului	personale
perspectiva	prospettiva
perspectivă	prospettiva
perspectivele	prospettive
perspective	prospettive
pesta	peste
petrolieră	petrolifera
petroliere	petrolifere
petrolier	petroliera
petrol	petrolio
petrolul	petrolio
pianistul	pianista
pierderi	perdita
pierd	perdono
pierdute	perdute
pietoni	pedoni
pietrele	pietre
pilot	pilota
pionierii	pionieri
piramida	piramide
piramidă	piramide
piramidei	piramide
planeta	pianeta
planetă	pianeta
planetei	pianeta
planificarea	pianificazione
planificare	pianificazione
planificării	pianificare
planificată	pianificata
planta	piantare
plantele	piante
plantelor	piante
plante	piante
planuri	piani
plasmă	plasma
plastice	plastiche
plastic	plastica
platforma	piattaforma
platformă	piattaforma
platformei	piattaforma
platformele	piattaforme
platforme	piattaforme
platină	platino
plauzibilă	plausibile
plauzibil	plausibile
plebiscit	plebiscito
poezie	poesia
polarizarea	polarizzazione
polarizare	polarizzazione
polar	polare
polen	polline
politică	politica
politice	politiche
politicii	politica
politicile	politiche
politici	politica
politic	politico
poliție	polizia
pompierii	pompieri
populară	popolare
populare	popolari
popularitatea	popolarità
popularitate	popolarità
populația	popolazione
populației	popolazione
populațiile	popolazioni
populațiilor	popolazioni
pornografice	pornografici
portabile	portatili
portal	portale
portalul	portale
portalului	portale
portaluri	portali
portavioane	portaerei
portavion	portaerei
portofoliul	portafoglio
portuare	portuali
portuar	portuale
portugheză	portoghese
portugheze	portoghese
portughezi	portoghesi
portughez	portoghese
porturi	porti
posesia	possesso
posibilă	possibile
posibilele	possibili
posibile	possibili
posibilitatea	possibilità
posibil	possibile
potabilă	potabile
potențialele	potenziali
potențiale	potenziali
potențial	potenziale
potențialul	potenziale
potențialului	potenziale
pozitivă	positiva
pozitive	positive
pozitiv	positivo
practică	pratica
practicate	praticati
practicile	pratiche
pragmatică	pragmatica
pragmatic	pragmatica
precară	precaria
precare	precarie
precauție	precauzione
precedat	preceduto
precedent	precedente
precisă	precisa
precise	precisi
precis	precisa
precursorii	precursori
precursorul	precursore
predominantă	predominante
predominante	predominanti
preferențial	preferenziale
preliminară	preliminare
preliminare	preliminari
preliminar	preliminare
preludiul	preludio
prelungite	prolungati
prematură	prematura
prematur	prematura
premise	premesse
preocupă	preoccupa
preocupare	preoccupazione
preocupărilor	preoccupazioni
preocupat	preoccupato
preparate	preparati
prerogativele	prerogative
presiunea	pressione
presiunii	pressione
presiuni	pressioni
prestigioasă	prestigioso
prestigioase	prestigiose
prestigios	prestigiosa
prestigiul	prestigio
prestigiului	prestigio
prestigiu	prestigio
pretendenți	pretendenti
pretext	pretesto
pretextul	pretesto
prevăzute	previste
prevăzut	previsto
preveni	prevenire
prevenirea	prevenire
prevenire	prevenzione
prevenirii	prevenzione
preventive	preventiva
preventiv	preventivo
previziuni	previsioni
prezenta	presentare
prezentate	presentate
prezente	presenti
prezidențiale	presidenziali
prezidențial	presidenziale
prezintă	presenta
prezinte	presentare
primară	primaria
primar	primaria
primate	primati
primitivă	primitivo
prim-ministrul	ministro
principala	principale
principală	principale
principalele	principali
principale	principali
principal	principale
principalul	principale
principatelor	principati
principat	principato
principiile	principi
principiilor	principi
principii	principi
principiul	principio
principiului	principio
principiu	principio
prioritate	priorità
prioritățile	priorità
priorități	priorità
privată	privata
privați	privati
privatizarea	privatizzazione
privatizare	privatizzazione
privatizării	privatizzazione
privat	privato
privilegiată	privilegiata
privilegiate	privilegiati
privilegiat	privilegiato
privilegiile	privilegi
privilegiilor	privilegi
privilegii	privilegi
privilegiul	privilegio
privilegiu	privilegio
prizonierii	prigionieri
prizonierilor	prigionieri
prizonieri	prigionieri
prizonier	prigioniero
prizonierul	prigioniero
probabile	probabili
probabilitatea	probabilità
probabil	probabilmente
problemă	problema
problemei	problema
problemele	problemi
problemelor	problemi
probleme	problemi
procedură	procedura
procedurii	procedura
procedurile	procedure
procedurilor	procedure
proceduri	procedura
procente	percentuali
procent	percentuale
procentul	percentuale
procesele	processi
procese	processi
proces	processo
procesul	processo
procesului	processo
proclama	proclamare
proclamarea	proclamazione
proclamată	proclamata
proclamat	proclamato
procurorii	procuratori
procurorilor	procuratori
procurori	procuratori
procuror	procuratore
procurorul	procuratore
procurorului	procuratore
producă	produrre
producătoare	produttrici
producătorii	produttori
producătorilor	produttori
producători	produttori
producător	produttore
producătorul	produttore
producătorului	produttore
producea	produceva
produce	produrre
produc	producono
producția	produzione
producției	produzione
producție	produzione
productivă	produttiva
productive	produttive
productivitatea	produttività
productivitate	produttività
productivității	produttività
productiv	produttiva
proeminent	preminente
profesia	professione
profesie	professione
profesii	professioni
profesională	professionale
profesionale	professionale
profesionalism	professionalità
profesional	professionale
profesioniști	professionisti
profesionist	professionista
profesori	professori
profesor	professor
profesorului	professor
profiluri	profili
profită	approfittando
profitând	approfitta
profit	profitto
profiturile	profitti
profituri	profitti
profundă	profonda
profunde	profonde
profund	profonda
programarea	programmazione
programare	programmazione
programatori	programmatori
programele	programmi
programelor	programmi
programe	programmi
program	programma
programul	programma
programului	programma
progresele	progressi
progrese	progressi
progresiste	progressiste
progresivă	progressiva
progresive	progressiva
progresiv	progressivo
progres	progressi
progresul	progressi
progresului	progresso
proiecte	progetti
proiect	progetto
proliferarea	proliferazione
promise	promessi
promite	promette
promoționale	promozionali
promotorii	promotori
promotor	promotore
promovând	promuovendo
promova	promuovere
promovarea	promuovere
promovat	promosso
promoveze	promuovere
propagandă	propaganda
propagandei	propaganda
proporții	proporzioni
proporțională	proporzionale
proporțional	proporzione
proprietarii	proprietari
proprietarilor	proprietari
proprietar	proprietario
proprietarul	proprietario
proprietatea	proprietà
proprietate	proprietà
propriile	proprie
proprii	proprie
propulsie	propulsione
propune	propone
propun	propongono
propuse	proposte
propus	proposto
prosperă	prospera
prospere	prosperare
prosperitate	prosperità
prosperității	prosperità
prosper	prospero
prostituate	prostituta
prostituția	prostituzione
prostituție	prostituzione
protecția	protezione
protecție	protezione
protectoare	protettiva
protectori	protettori
protector	protettivo
proteine	proteico
protejarea	proteggere
protestantă	protestante
protestante	protestanti
protesta	protestare
protestează	protesta
protestele	proteste
protestelor	proteste
protest	protesta
protocoalele	protocolli
protocoale	protocolli
protocol	protocollo
protocolul	protocollo
protocolului	protocollo
prototipul	prototipo
proveneau	proveniva
proveni	provenga
provinciei	provincia
provincie	provincia
provinciile	province
provinciilor	province
provincii	province
provine	proviene
provin	provengono
provizorie	provvisoria
provizorii	provvisori
provizoriu	provvisoria
provoacă	provoca
provocând	provocando
provoca	provocare
provocatoare	provocatorio
provocator	provocatorio
provocat	provocato
prudent	prudente
psihiatrice	psichiatrici
psihiatriei	psichiatria
psihiatru	psichiatra
psihologia	psicologia
psihologică	psicologica
psihologice	psicologiche
psihologic	psicologica
publicând	pubblicando
publică	pubblica
publica	pubblicare
publicarea	pubblicazione
publicată	pubblicata
publicate	pubblicate
publicațiile	pubblicazioni
publicații	pubblicazioni
publicat	pubblicata
publice	pubbliche
publicitare	pubblicitarie
publicitar	pubblicitari
publicitatea	pubblicità
publicitate	pubblicità
publicității	pubblicità
publicul	pubblico
publicului	pubblico
pulmonare	polmonari
pulmonar	polmoni
punct	punto
rabin	rabbino
radarul	radar
radarului	radar
radiațiile	radiazioni
radiații	radiazioni
radicală	radicale
radicale	radicali
radical	radicale
radioactivă	radioattiva
radioactive	radioattive
radioactivitate	radioattività
radioactiv	radioattivo
rafinărie	raffineria
rafinării	raffinerie
ramificații	ramificazioni
rampă	rampa
rapidă	rapida
rapide	rapida
rapid	rapida
raportate	riportati
raportor	relatore
rasială	razziale
rasiale	razziale
rasism	razzismo
rasismul	razzismo
rasiste	razzista
rasist	razzista
răspunde	risponde
ratificarea	ratifica
ratificată	ratificata
ratificat	ratificato
rațională	razionale
raționale	razionali
rațional	razionale
reabilitarea	riabilitazione
reabilitare	riabilitazione
reactive	reattiva
reactiv	reattiva
reactor	reattore
reale	reali
realism	realismo
realismul	realismo
realistă	realistica
realiste	realistiche
realist	realistica
realitate	realtà
rebele	ribelli
rebelii	ribelli
rebelilor	ribelli
rebeliune	ribellione
rebel	ribelle
recensământul	censimento
recensăminte	censimenti
recentă	recente
recente	recenti
recent	recente
recesiune	recessione
reciclare	riciclaggio
reciproce	reciproche
recolte	raccolti
recomandarea	raccomanda
recomandare	raccomandazione
recomandări	raccomandazioni
recomandate	raccomandati
recomandat	raccomandato
recompensă	ricompensa
recompensa	ricompensare
recompensat	ricompensato
recompense	ricompense
reconcilierea	conciliare
reconciliere	riconciliazione
reconstituie	ricostruisce
reconstituită	ricostituita
reconstituit	ricostituito
reconstrucția	ricostruzione
reconstrucție	ricostruzione
reconstruiască	ricostruire
reconstruirea	ricostruire
reconstrui	ricostruire
reconstruite	ricostruite
recordul	record
recrutarea	reclutare
recrutare	reclutamento
recrutat	reclutato
recruteze	reclutare
recunoscute	riconosciute
recupera	recuperare
recupereze	recuperare
recurentă	ricorrente
recurente	ricorrenti
recurs	ricorsi
reducerea	ridurre
reducere	ridurre
reduce	ridurre
referendumul	referendum
referendumului	referendum
reflectând	riflettendo
reflectă	riflette
reflecte	riflettere
reformarea	riformare
reforma	riforma
reformă	riforma
reformată	riformata
reformate	riformati
reformator	riformista
reformat	riformato
reformei	riforma
reformele	riforme
reformelor	riforme
reformeze	riformare
refugiat	rifugiato
refugieze	rifugio
refugiu	rifugio
refuzat	rifiutati
regenerabile	energie
regimente	reggimenti
regim	regime
regimul	regime
regională	regionale
regionale	regionali
regional	regionale
registrele	registri
registre	registri
registrul	registro
registru	registro
regiune	regione
reglementarea	regolamentare
reglementa	regolamentare
reglementare	regolamentazione
reglementările	regolamenti
reglementărilor	regolamenti
reglementări	regolamenti
reglementată	regolamentata
reglementat	regolamentata
regres	regressione
regulamentele	regolamenti
regulamente	regolamenti
regulament	regolamento
regulamentul	regolamento
regulamentului	regolamento
regulate	regolari
reintrodus	reintrodotto
relansarea	rilanciare
relațiilor	relazioni
relativ	relativamente
religia	religione
religiei	religione
religie	religione
religiile	religioni
religiilor	religioni
religii	religioni
religioasă	religiosa
religioase	religiose
religios	religioso
reorganizarea	riorganizzare
reorganizării	riorganizzazione
reorganizată	riorganizzata
repararea	riparare
repara	riparare
reparații	riparazioni
repatrierea	rimpatrio
repercusiuni	ripercussioni
represaliile	rappresaglie
represalii	rappresaglie
represiunea	repressione
represiune	repressione
represiunii	repressione
reprezentanții	rappresentanti
reprezentanților	rappresentanti
reprezentanți	rappresentanti
reprezentant	rappresentante
reprezentantul	rappresentante
reprezenta	rappresentanza
reprezentarea	rappresentare
reprezentare	rappresentanza
reprezentată	rappresentata
reprezentate	rappresentate
reprezentați	rappresentati
reprezentativă	rappresentativa
reprezentative	rappresentative
reprezentativ	rappresentativo
reprezentat	rappresentato
reprezentau	rappresentavano
reprezinte	rappresentare
reproducere	riproduzione
republicane	repubblicane
republicani	repubblicani
republică	repubblica
republicii	repubblica
republicile	repubbliche
republici	repubbliche
reputația	reputazione
reputație	reputazione
rescrie	riscrivere
respectând	rispettando
respectă	rispetta
respecta	rispettare
respectată	rispettata
respectate	rispettate
respecte	rispettare
respective	rispettive
respiratorii	respiratorie
respirator	respiratori
responsabilă	responsabile
responsabile	responsabili
responsabilitatea	responsabilità
responsabilitate	responsabilità
responsabil	responsabile
restabilirea	ristabilire
restabili	ristabilire
restabilită	ristabilita
restabilit	ristabilito
restaurante	ristoranti
restituirea	restituzione
restricțiile	restrizioni
restricțiilor	restrizioni
restricții	restrizioni
restructurarea	ristrutturazione
restructurare	ristrutturazione
restul	resto
resursele	risorse
resurse	risorse
retrage	ritirare
retrase	ritirate
retrospectivă	retrospettiva
reunificarea	riunificazione
reuni	riunire
reuniți	riuniti
reunit	riuniti
reuniune	riunione
reuniuni	riunione
revendicat	rivendicato
revolta	rivolta
revoltele	rivolte
revoluția	rivoluzione
revoluție	rivoluzione
revoluțiilor	rivoluzioni
revoluții	rivoluzioni
revoluționare	rivoluzionarie
revoluționar	rivoluzionario
rezerve	riserve
rezidențiale	residenziali
rezident	residente
rezistentă	resistenti
rezistente	resistenti
reziste	resistere
rezultatele	risultati
rezultate	risultati
rezultat	risultato
rezultatul	risultato
rigidă	rigida
rigide	rigidità
riguroasă	rigorosa
riguros	rigorosa
riscul	rischio
riscurile	rischi
rituală	rituale
ritual	rituale
ritualuri	rituali
rivale	rivali
rivalii	rivali
rivalitate	rivalità
rivalul	rivale
rivalului	rivale
robustă	robusta
robust	robusto
rocă	roccia
romană	romana
română	romena
române	rumene
roman	romano
român	romeno
romantică	romantica
romantice	romantiche
romantismul	romanticismo
romanul	romanzo
rotația	rotazione
rotundă	rotonda
rotunde	rotonde
rubrică	rubrica
rubrici	rubriche
rudimentar	rudimentale
ruinat	rovinato
ruinele	rovine
ruine	rovine
rurală	rurale
rurale	rurali
rusă	russa
rusesc	russo
rusești	russe
rutină	routine
sabotaj	sabotaggio
sacră	sacra
sacre	sacri
sacrifică	sacrifica
sacrificat	sacrificato
sacrifice	sacrificare
sacrificiile	sacrifici
sacrificii	sacrifici
sacrificiul	sacrificio
sacrificiului	sacrificio
sacrificiu	sacrificio
sacru	sacro
salariilor	salari
salarii	salari
salariul	salario
salariu	salario
saloanele	saloni
salvează	salva
salveze	salvare
șampanie	champagne
sancțiuni	sanzioni
sanitare	sanitarie
șantier	cantiere
sârbă	serba
sârb	serbo
satelit	satellite
satirice	satirici
satisface	soddisfare
scandal	scandalo
scandalul	scandalo
scandalului	scandalo
scandaluri	scandali
scandinave	scandinavi
scandinav	scandinavo
scenariile	scenari
scenarii	scenari
scenariul	scenario
scenariu	scenario
scenele	scene
sceptici	scettici
scepticism	scetticismo
scepticismul	scetticismo
sceptic	scettico
schelet	scheletro
schismă	scisma
schizofrenie	schizofrenia
sclavia	schiavitù
sclavie	schiavi
sclavii	schiavo
sclavi	schiavi
sclav	schiavitù
școlile	scuole
scrie	scrive
scrise	iscritto
scris	scritte
scrupule	scrupoli
sculptura	scultura
secesiunea	secessione
secesiune	secessione
secesiunii	secessione
secole	secoli
secretariatul	segretariato
secretariatului	segretariato
secretar	segretario
secretarul	segretario
secretă	segreta
secrete	segrete
secretul	segreto
sectă	setta
secțiunea	sezione
secțiuni	sezioni
sectoare	settori
sector	settore
sectorul	settore
secundară	secondaria
secundar	secondaria
secunde	secondi
securitatea	sicurezza
segmente	segmenti
segmentul	segmento
seismică	sismica
selectivă	selettiva
selectiv	selettiva
semantică	semantica
semantice	semantica
semantic	semantico
semestru	semestre
semiconductoare	semiconduttori
seminarii	seminari
seminar	seminario
semnal	segnale
semnatari	firmatari
semnificativă	significativa
semnificative	significative
semnificativ	significativa
senator	senatore
senatul	senato
sensibilă	sensibile
sensibile	sensibili
sensibilitatea	sensibilità
sensibilitate	sensibilità
sensibil	sensibile
sentimentală	sentimentale
sentimentele	sentimenti
sentimentelor	sentimenti
sentimente	sentimenti
sentimentul	sentimento
separă	separa
separa	separare
separate	separati
separatistă	separatista
separatiste	separatista
separatist	separatista
separat	separata
separe	separarsi
septembrie	settembre
seră	serra
serverul	server
serviciile	servizi
serviciilor	servizi
servicii	servizi
serviciul	servizio
serviciului	servizio
serviciu	servizio
servi	servire
servitor	servo
servit	servito
sesiunea	sessione
sesiune	sessione
sesiunii	sessione
sesiuni	sessioni
sexuală	sessuale
sexuale	sessuale
sexualitatea	sessualità
sexualitate	sessualità
sexual	sessuale
siciliană	siciliana
sicilian	siciliano
simbioză	simbiosi
simbolice	simboliche
simbolic	simbolica
simbolismul	simbolismo
simbolizează	simboleggia
simbol	simbolo
simbolul	simbolo
simbolurile	simboli
simetria	simmetria
simetrice	simmetrico
simetrie	simmetria
simfonie	sinfonia
similară	simile
similare	simili
similar	simile
simpatie	simpatia
simplificarea	semplificare
simplificată	semplificata
simplificate	semplificata
simplificat	semplificato
simplitate	semplicità
simptome	sintomi
simptom	sintomo
simulează	simula
simultană	simultanea
simultane	simultanea
simultan	simultaneamente
sinagogă	sinagoga
sinagogi	sinagoga
sinceră	sincera
sinceritatea	sincerità
sindicală	sindacale
sindicale	sindacale
sindicatele	sindacati
sindicatelor	sindacali
sindicate	sindacati
sindicat	sindacato
sindicatul	sindacato
sindromul	sindrome
sinonim	sinonimo
sinucidă	suicidio
sirenă	sirene
sirian	siriano
sirieni	siriani
sistematică	sistematica
sistematice	sistematiche
sistematic	sistematica
sistem	sistema
situată	situata
situate	situati
situația	situazione
situație	situazione
situații	situazioni
situat	situato
sloganul	slogan
slovacă	slovacca
slovace	slovacca
slovaci	slovacchi
slovac	slovacco
slovenă	slovena
sloven	sloveno
sobră	sobria
socială	sociale
social-democrații	socialdemocratici
social-democrat	socialdemocratico
sociale	sociali
socialism	socialismo
socialismul	socialismo
socialismului	socialismo
socialistă	socialista
socialiste	socialisti
socialiștii	socialisti
socialiști	socialisti
socialist	socialista
socializare	socializzazione
societate	società
sociolog	sociologo
sodiu	sodio
sofisticate	sofisticati
solară	solare
solare	solari
solar	solare
soldatul	soldato
soldatului	soldato
solemne	solenni
solemn	solenne
solidaritatea	solidarietà
solidaritate	solidarietà
solidă	solida
solide	solida
solid	solido
soluție	soluzione
soluții	soluzioni
sondaje	sondaggi
sondaj	sondaggio
sovietică	sovietica
sovietice	sovietiche
sovietic	sovietico
spaniolă	spagnola
spaniole	spagnola
spanioli	spagnolo
spaniol	spagnoli
spațială	spaziale
spațiale	spaziali
specială	speciale
speciale	speciali
specialiștilor	specialisti
specialiști	specialisti
specialist	specialista
specialitate	specializzate
specializarea	specializzazione
specializare	specializzazione
specializată	specializzata
specializate	specializzate
specializat	specializzato
specificat	specificato
specifice	specifiche
specific	specifica
spectacolelor	spettacoli
spectacole	spettacoli
spectacol	spettacolo
spectacolul	spettacolo
spectacolului	spettacolo
spectaculoasă	spettacolare
spectaculoase	spettacolare
spectaculos	spettacolare
spectatori	spettatori
spectator	spettatore
spectrul	spettro
spectru	spettro
speculațiile	speculazione
speculații	speculazioni
speculativă	speculativa
spera	sperare
spionaj	spionaggio
spionajul	spionaggio
spirala	spirale
spirală	spirale
spirit	spirito
spirituală	spirituale
spirituale	spirituali
spiritualitate	spiritualità
spiritual	spirituale
spiritul	spirito
splendid	splendido
sponsori	sponsor
spontană	spontanea
spontane	spontanee
spontan	spontaneo
sporadice	sporadiche
sporadic	sporadicamente
sportivă	sportiva
sportive	sportiva
sportivii	sportivi
sportivilor	sportivi
sportiv	sportiva
sportul	sport
sportului	sport
stabilă	stabile
stabile	stabili
stabilește	stabilisce
stabili	stabilire
stabilită	stabilita
stabilitatea	stabilità
stabilitate	stabilità
stabilității	stabilità
stabilite	stabiliti
stabilit	stabilito
stabilizare	stabilizzazione
stabilizat	stabilizzato
stabil	stabile
stagnare	ristagno
stalinismului	stalinismo
statică	statica
statice	statiche
static	statica
statistică	statistica
statistice	statistiche
statisticile	statistiche
statisticilor	statistiche
statistici	statistiche
statistic	statistico
statuie	statua
statuile	sante
statutul	statuto
statutului	statuto
stilistic	stilistica
stimularea	stimolare
stimulare	stimolare
stimula	stimolare
strategică	strategica
strategice	strategiche
strategic	strategico
strategiei	strategia
strategie	strategia
strategiile	strategie
strategiilor	strategie
strategii	strategia
stres	stress
strict	stretto
structurală	strutturale
structurale	strutturali
structural	strutturale
structurarea	strutturazione
structura	struttura
structură	struttura
structurată	strutturata
structurate	strutturata
structurat	strutturato
structurii	struttura
structurile	strutture
structurilor	strutture
structuri	struttura
studentă	studentessa
student	studente
studia	studiare
studiate	studiati
studiat	studiato
studieze	studiare
stupid	stupida
subiective	soggettive
submarine	sottomarini
subordonarea	subordinazione
subordonare	subordinazione
subordonată	subordinata
subordonate	subordinate
subordonat	subordinato
subsecretar	sottosegretario
substanțelor	sostanze
substanțe	sostanze
substanțială	sostanziale
substanțial	sostanziale
subterane	sotterranee
subvenții	sovvenzioni
subzistență	sussistenza
succedat	succeduto
succesiunea	successione
succesiune	successione
succesiunii	successione
succesive	successive
succesoare	successori
succesorii	successori
succesor	successore
succesorul	successore
succesorului	successore
succes	successo
succesul	successo
sud-coreean	sudcoreano
sud-estul	sud-est
sud-vestul	sud-ovest
suferit	sofferto
suficientă	sufficiente
suficiente	sufficiente
suficient	sufficiente
sugera	suggerire
sugerează	suggerisce
sugereze	suggerire
sugestie	suggerimento
sugestii	suggerimenti
superficială	superficiale
superficiale	superficiali
superficial	superficiale
superioritatea	superiorità
superioritate	superiorità
supermarket	supermercato
supleant	supplente
suplimentară	supplementare
suplimentare	supplementari
suplimentar	supplementare
supliment	supplemento
suporte	sopportare
suprarealistă	surreale
supraviețui	sopravvivere
supremă	suprema
supremația	supremazia
suprem	supremo
surdă	sorda
surplusul	surplus
surprindă	sorprendere
surprinderea	sorpresa
surprinde	sorprende
surprins	sorpresa
surprize	sorprese
suspectați	sospettati
suspectat	sospettata
suspecte	sospette
suspendarea	sospendere
suverană	sovrana
suverane	sovrani
suveranitatea	sovranità
suveranitate	sovranità
suveranității	sovranità
suveran	sovrano
tabelele	tabelle
tabele	tabelle
tactica	tattica
tactică	tattica
tactice	tattiche
tacticile	tattiche
tactici	tattica
tactic	tattico
talentele	talenti
talente	talenti
talentul	talenti
talentului	talenti
tampon	tampone
tarife	tariffe
tehnică	tecnica
tehnice	tecniche
tehnic	tecnica
tehnologia	tecnologia
tehnologică	tecnologica
tehnologice	tecnologiche
tehnologic	tecnologici
tehnologiei	tecnologia
tehnologie	tecnologia
tehnologiile	tecnologie
tehnologiilor	tecnologie
tehnologii	tecnologie
telecomunicațiilor	telecomunicazioni
telecomunicații	telecomunicazioni
telefonie	telefonia
telegramă	telegramma
telescopului	telescopio
telespectatori	telespettatori
tematice	tematica
temperat	temperata
temperatură	temperatura
temperaturii	temperatura
temperaturile	temperature
temperaturilor	temperature
temperaturi	temperature
templelor	templi
templul	tempio
templului	tempio
templu	tempio
temporară	temporanea
temporare	temporanea
temporar	temporanea
tendința	tendenza
tendință	tendenza
tendințele	tendenze
tendințe	tendenze
tenis	tennista
tensiune	tensione
tensiunile	tensioni
tensiunilor	tensioni
tensiuni	tensioni
teologie	teologia
teorie	teoria
teoriile	teorie
terapeutică	terapeutica
terapeutice	terapeutiche
terapeutic	terapeutica
terapie	terapia
terapii	terapie
teren	terreno
terenurile	terreni
terestră	terrestre
terestre	terrestri
terestru	terrestre
teribil	terribile
teritorială	territoriale
teritoriale	territoriale
teritoriile	territori
teritoriilor	territori
teritorii	territori
teritoriul	territorio
teritoriului	territorio
teritoriu	territorio
termale	termali
termeni	termini
termen	termine
termică	termica
termice	termica
terminale	terminal
teroarea	terrore
teroare	terrore
terorism	terrorismo
terorismul	terrorismo
terorismului	terrorismo
teroristă	terrorista
teroriste	terroristi
terorist	terrorista
terțe	terzi
testamentul	testamento
testată	testata
testa	testare
testate	testati
texte	testi
textile	tessile
textil	tessile
tibetană	tibetana
tibetan	tibetano
tigrii	tigri
tigrului	tigre
tigru	tigre
timidă	timida
timid	timido
tirania	tirannia
tiran	tiranno
titluri	titoli
titularul	titolare
toate	tutte
toleranța	tolleranza
toleranță	tolleranza
tolera	tollerare
tolerat	tollerato
topografie	topografia
torturați	torturati
tortura	tortura
tortură	torture
torturat	torturato
torturii	tortura
totală	totale
totale	totali
totalitarismului	totalitarismo
total	totale
totalul	totali
toxică	tossica
toxice	tossiche
toxicitatea	tossicità
toxicitate	tossicità
toxic	tossica
toxine	tossine
tractoare	trattori
tractor	trattore
tradiția	tradizione
tradiție	tradizione
tradițiile	tradizioni
tradițiilor	tradizioni
tradiții	tradizioni
tradițională	tradizionale
tradiționale	tradizionali
tradițional	tradizionale
traducători	traduttori
traducerea	traduzione
traducere	traduzione
traducerii	traduzione
traduceri	traduzioni
traduse	tradotte
traficul	traffico
traficului	traffico
tragediei	tragedia
tragedie	tragedia
tragedii	tragedia
tragică	tragica
tragice	tragiche
tragic	tragico
trambulină	trampolino
transatlantic	transatlantico
transcriere	trascrizione
transferarea	trasferendo
transferată	trasferita
transferate	trasferite
transferă	trasferire
transfera	trasferisce
transferat	trasferito
transfere	trasferire
transfer	trasferimento
transferul	trasferimento
transferului	trasferimento
transferurile	trasferimenti
transferuri	trasferimenti
transformând	trasformando
transformarea	trasformare
transformare	trasformazione
transformării	trasformazione
transformările	trasformazioni
transformărilor	trasformazioni
transformări	trasformazioni
transformată	trasformata
transformate	trasformate
transformă	trasforma
transforma	trasformare
transformat	trasformata
transforme	trasformare
transmisă	trasmessa
transmise	trasmesse
transmisie	trasmissione
transmită	trasmettere
transmitere	trasmissione
transmite	trasmettere
transparența	trasparente
transparentă	trasparenza
transparență	trasparenza
transparente	trasparente
transparent	trasparente
transplant	trapianti
transportată	trasportata
transportate	trasportate
transportă	trasporta
transporta	trasportare
transportat	trasportato
transport	trasporti
transportul	trasporti
transportului	trasporti
transporturilor	trasporti
transpusă	trasposta
transpus	trasposto
transversală	trasversale
transversale	trasversali
tranzacție	transazione
tranziția	transizione
tranziție	transizione
tranzit	transito
tratamentele	trattamenti
tratamente	trattamenti
tratament	trattamento
tratamentul	trattamento
tratamentului	trattamento
tratate	trattate
tratat	trattato
tratează	trattano
traume	traumi
traversa	attraversare
traversează	attraversa
traverseze	attraversare
trezorier	tesoriere
tribală	tribale
tribale	tribali
tribunalele	tribunali
tribună	tribuna
triburi	tribù
tripartit	tripartito
triplă	triplice
triplu	triplice
tristă	triste
triste	tristi
trist	triste
triunghiul	triangolo
tropicală	tropicale
tropicale	tropicali
tropical	tropicale
tropice	tropici
trupele	truppe
trupelor	truppe
trupe	truppe
tuberculoza	tubercolosi
tuberculoză	tubercolosi
tuberculozei	tubercolosi
tunelului	tunnel
turbinele	turbine
turce	turche
turci	turchi
turism	turismo
turismul	turismo
turismului	turismo
turistică	turistica
turistice	turistiche
turistic	turistici
turiști	turisti
turist	turista
ucraineană	ucraina
ucrainean	ucraino
ucrainene	ucraine
ucraineni	ucraini
umană	umana
umane	umana
umanism	umanesimo
umanistă	umanistica
umaniste	umanista
umanist	umanista
umanitară	umanitari
umanitare	umanitarie
umanitar	umanitari
umanitatea	umanità
umanitate	umanità
umanității	umanità
umbră	ombra
umbrele	ombre
umede	umide
umilit	umiliato
umoristice	umoristico
unanimă	unanime
unanimitate	unanime
unanim	unanime
unice	unico
unificarea	unificare
unificare	unificazione
unificării	unificazione
unificată	unificata
unificate	unificato
unificat	unificato
uniforma	uniforme
uniformă	uniforme
uniforme	uniformi
uniform	uniforme
unilaterală	unilaterale
unilateral	unilaterale
unitare	unitaria
unitar	unitario
unitate	unità
uniune	unione
uniuni	unioni
universală	universale
universal	universale
universitară	universitaria
universitare	universitarie
universitar	universitaria
universitate	universitari
universități	università
universul	universo
uraganul	uragano
uragan	uragano
uraniu	uranio
urbană	urbana
urbane	urbana
urbanism	urbanistica
urban	urbani
urechile	orecchie
urgență	urgente
urgentă	urgenza
urgent	urgente
utilă	utile
utile	utili
utilitatea	utilità
utilitate	utilità
utilizând	utilizzando
utilizată	utilizzata
utilizate	utilizzate
utilizatorii	utilizzatori
utilizatori	utilizzatori
utilizat	utilizzato
utiliza	utilizzare
utilizau	utilizzavano
utilizează	utilizza
utilizeze	utilizzare
utopie	utopia
vacant	vacante
vacă	vacca
vaccinarea	vaccinazione
vaccinare	vaccinazione
vaccinul	vaccino
vaccinurile	vaccini
vaccinuri	vaccini
vagoane	vagoni
valabile	valide
valabilitate	validità
valea	valle
validitatea	validità
valoare	valore
valve	valvole
vândută	venduta
vândute	vendute
vândut	venduto
variabila	variabile
variabilă	variabile
variabilelor	variabili
variante	varianti
variațiilor	variazioni
variații	varianti
variat	variegato
varia	variare
variază	varia
varietate	varietà
vasali	vassalli
vasculare	vascolari
vegetală	vegetale
vegetale	vegetali
vegetarian	vegetariana
vehicule	veicoli
vehicul	veicolo
venerabil	venerabile
verbale	verbali
verificarea	verifica
verificare	verifica
verificat	verificato
verifica	verificare
versiunea	versione
versiune	versione
versiuni	versioni
verticală	verticale
verticale	verticali
vertical	verticalmente
verzi	verdi
vestigii	vestigia
veterinară	veterinaria
veterinar	veterinario
victima	vittima
victimele	vittime
victimelor	vittime
victime	vittime
victoria	vittoria
victorie	vittoria
victorii	vittorie
victorioși	vittorioso
video	videogiochi
vietnameză	vietnamita
vinde	vende
violența	violenta
violentă	violenza
violență	violenza
violenței	violenza
violente	violenta
violent	violenta
virală	virale
virgine	vergini
virgulă	virgola
virtuală	virtuale
virtuale	virtuali
virusului	virus
virusul	virus
vitală	vitale
vitale	vitali
vitalitate	vitalità
vitaminei	vitamina
viticultură	viticoltura
vizibilă	visibile
vizibile	visibili
vizibilitatea	visibilità
vizibilitate	visibilità
vizibil	visibile
vizitat	visitato
vizita	visita
vizită	visita
vizitei	visita
vizitele	visite
vizite	visite
viziteze	visitare
viziune	visione
viziuni	visioni
vizuale	visuale
vocabularului	vocabolario
vocabularul	vocabolario
volatile	volatili
volumele	volumi
volume	volumi
volumului	volume
volumul	volume
volum	volume
voluntară	volontaria
voluntare	volontarie
voluntariat	volontariato
voluntari	volontari
votate	votati
votat	votato
voteze	votare
vulcanică	vulcanica
vulcanice	vulcaniche
vulcanii	vulcani
vulcanului	vulcano
vulcanul	vulcano
vulcan	vulcano
vulgară	volgare
vulnerabilă	vulnerabile
vulnerabile	vulnerabili
vulnerabilitatea	vulnerabilità
vulnerabil	vulnerabile
